Payments,Costs,Profit,Age,Gender,AgeGroup
9400,8100,1300,19,male,18-24
26600,13900,12700,29,male,25-39
9750,6750,3000,20,male,18-24
29700,11200,18500,18,female,18-24
49700,10450,39250,21,female,18-24
14300,7500,6800,18,male,18-24
30300,11400,18900,18,female,18-24
53100,17800,35300,21,female,18-24
10300,7700,2600,18,male,18-24
111400,35650,75750,21,male,18-24
13500,9200,4300,19,male,18-24
18900,13250,5650,31,Female,25-39
18700,13250,5450,37,Female,25-39
10450,7650,2800,18,male,18-24
9300,8800,500,18,male,18-24
44150,17150,27000,19,female,18-24
18850,14850,4000,31,male,25-39
48500,18000,30500,18,female,18-24
8850,7750,1100,19,male,18-24
49850,21100,28750,21,female,18-24
36900,15950,20950,19,female,18-24
49850,11900,37950,18,female,18-24
8950,7300,1650,18,male,18-24
21000,10200,10800,36,Female,25-39
10100,7400,2700,19,male,18-24
13750,6400,7350,18,male,18-24
24350,12100,12250,28,male,25-39
10250,7600,2650,19,male,18-24
8500,6950,1550,18,male,18-24
20350,16250,4100,30,FEMALE,25-39
10300,6650,3650,19,male,18-24
37500,20300,17200,18,female,18-24
51350,16900,34450,18,female,18-24
33000,18100,14900,18,female,18-24
9050,7350,1700,19,male,18-24
11300,11700,-400,38,Female,25-39
41600,12600,29000,19,female,18-24
43000,10000,33000,19,female,18-24
19750,12950,6800,25,female,25-39
9650,8750,900,19,male,18-24
10450,8950,1500,18,male,18-24
10700,7600,3100,19,male,18-24
35800,17950,17850,18,female,18-24
8250,8450,-200,19,male,18-24
11150,7450,3700,20,male,18-24
48250,16850,31400,22,female,18-24
10400,7850,2550,18,male,18-24
27200,13750,13450,26,male,25-39
8500,9100,-600,20,male,18-24
10700,6700,4000,19,male,18-24
10500,8400,2100,18,male,18-24
10450,6750,3700,19,male,18-24
24550,9750,14800,28,male,25-39
18700,16150,2550,28,male,25-39
19650,12900,6750,30,male,25-39
62500,17750,44750,23,female,18-24
6600,9300,-2700,18,male,18-24
9000,8650,350,18,male,18-24
6850,8650,-1800,20,male,18-24
8450,8250,200,20,male,18-24
26250,11450,14800,34,male,25-39
20350,10700,9650,27,male,25-39
46150,16800,29350,22,female,18-24
9400,7200,2200,18,male,18-24
8800,8200,600,20,male,18-24
51200,10450,40750,18,female,18-24
6550,7900,-1350,20,male,18-24
128950,40150,88800,21,male,18-24
40250,14250,26000,19,female,18-24
13800,6800,7000,20,male,18-24
10100,9750,350,18,male,18-24
47300,19400,27900,19,female,18-24
12150,8000,4150,18,male,18-24
42200,20250,21950,18,female,18-24
8250,7200,1050,20,male,18-24
10850,7900,2950,18,male,18-24
9450,6600,2850,19,male,18-24
10600,8000,2600,18,male,18-24
47550,18150,29400,21,female,18-24
9550,7800,1750,19,male,18-24
116550,44850,71700,24,male,18-24
14200,9850,4350,19,male,18-24
33900,13100,20800,18,female,18-24
25250,11000,14250,38,Female,25-39
45100,16100,29000,21,female,18-24
11800,8300,3500,18,male,18-24
18450,11750,6700,28,female,25-39
8500,10250,-1750,18,male,18-24
39950,18250,21700,19,female,18-24
7250,8000,-750,20,male,18-24
126500,41650,84850,23,male,18-24
19650,7300,12350,29,FEMALE,25-39
35200,13900,21300,19,female,18-24
10100,7400,2700,19,male,18-24
15750,12050,3700,25,female,25-39
7250,9350,-2100,18,male,18-24
9850,7000,2850,20,male,18-24
25900,14850,11050,25,female,25-39
12500,7600,4900,19,male,18-24
133150,33500,99650,23,male,18-24
10600,9100,1500,19,male,18-24
12400,10000,2400,18,male,18-24
26500,12550,13950,27,female,25-39
19150,14450,4700,35,Female,25-39
44500,20800,23700,24,female,18-24
38200,16300,21900,18,female,18-24
7800,9800,-2000,19,male,18-24
7900,6900,1000,19,male,18-24
10350,8750,1600,18,male,18-24
56900,11700,45200,19,female,18-24
26050,12600,13450,25,female,25-39
6200,7900,-1700,18,male,18-24
10600,7350,3250,18,male,18-24
8850,7300,1550,18,male,18-24
48350,11650,36700,18,female,18-24
115450,44250,71200,21,male,18-24
46900,11150,35750,19,female,18-24
9300,7900,1400,18,male,18-24
9600,7750,1850,18,male,18-24
124800,40150,84650,24,male,18-24
44700,14900,29800,18,female,18-24
17000,11600,5400,31,male,25-39
21200,10050,11150,29,male,25-39
7750,8100,-350,18,male,18-24
9000,7350,1650,20,male,18-24
38800,16850,21950,18,female,18-24
6300,6200,100,19,male,18-24
45550,20150,25400,21,female,18-24
11950,8050,3900,19,male,18-24
44050,11700,32350,18,female,18-24
33000,15900,17100,19,female,18-24
13150,7450,5700,18,male,18-24
11300,8000,3300,18,male,18-24
12300,8750,3550,18,male,18-24
39000,19900,19100,19,female,18-24
20300,14500,5800,29,male,25-39
9950,8250,1700,18,male,18-24
8450,6700,1750,19,male,18-24
19950,11300,8650,25,male,25-39
8350,7550,800,19,male,18-24
9350,6950,2400,20,male,18-24
36600,14600,22000,19,female,18-24
13000,8900,4100,18,male,18-24
22250,13800,8450,34,male,25-39
11350,8350,3000,18,male,18-24
12200,8200,4000,18,male,18-24
12100,7500,4600,18,male,18-24
21250,13000,8250,26,male,25-39
13550,7400,6150,19,male,18-24
42400,13700,28700,18,female,18-24
10900,7150,3750,20,male,18-24
43700,15600,28100,21,female,18-24
22450,11500,10950,32,Female,25-39
8900,7850,1050,19,male,18-24
46550,14250,32300,18,female,18-24
44650,18000,26650,18,female,18-24
5550,7500,-1950,18,male,18-24
34550,13900,20650,18,female,18-24
55200,19800,35400,19,female,18-24
4900,8350,-3450,18,male,18-24
121200,41400,79800,22,male,18-24
113150,27000,86150,23,male,18-24
107050,45900,61150,21,male,18-24
8700,8250,450,18,male,18-24
9900,9350,550,18,male,18-24
51150,21700,29450,18,female,18-24
20150,12050,8100,37,male,25-39
20500,12850,7650,25,female,25-39
29200,13950,15250,29,male,25-39
15650,10950,4700,25,male,25-39
9650,11200,-1550,18,male,18-24
49150,20900,28250,22,female,18-24
11650,8500,3150,20,male,18-24
33950,17550,16400,18,female,18-24
32100,13950,18150,18,female,18-24
52150,14950,37200,19,female,18-24
12400,8950,3450,18,male,18-24
12100,8250,3850,19,male,18-24
55050,17950,37100,22,female,18-24
29000,16000,13000,19,female,18-24
49250,16800,32450,19,female,18-24
16100,12450,3650,38,male,25-39
21300,11800,9500,26,female,25-39
20250,7200,13050,25,female,25-39
13800,10450,3350,32,Female,25-39
30750,16050,14700,18,female,18-24
18350,16000,2350,29,male,25-39
6800,7400,-600,18,male,18-24
12300,8350,3950,19,male,18-24
25300,10400,14900,35,Female,25-39
55400,14200,41200,22,female,18-24
20200,15650,4550,28,female,25-39
20550,13250,7300,29,FEMALE,25-39
17100,11350,5750,28,male,25-39
53350,24650,28700,22,female,18-24
11800,8450,3350,19,male,18-24
22850,9000,13850,18,female,18-24
20950,11650,9300,32,male,25-39
20200,11950,8250,27,male,25-39
22350,12000,10350,35,Female,25-39
18850,12150,6700,27,male,25-39
34850,14550,20300,18,female,18-24
20850,15900,4950,18,female,18-24
40950,15850,25100,18,female,18-24
41000,20500,20500,18,female,18-24
10450,8400,2050,18,male,18-24
24200,10400,13800,37,Female,25-39
10950,7000,3950,19,male,18-24
11800,7800,4000,18,male,18-24
47050,17450,29600,21,female,18-24
19050,10450,8600,30,FEMALE,25-39
8400,5850,2550,18,male,18-24
16350,8900,7450,26,male,25-39
8600,8650,-50,20,male,18-24
7000,8400,-1400,19,male,18-24
27500,12800,14700,38,Female,25-39
25950,13700,12250,38,Female,25-39
35800,12200,23600,22,female,18-24
52050,17000,35050,19,female,18-24
11300,6150,5150,19,male,18-24
8550,8250,300,19,male,18-24
19950,11100,8850,25,female,25-39
45600,16300,29300,19,female,18-24
41600,22600,19000,22,female,18-24
23250,14000,9250,32,male,25-39
46050,18700,27350,18,female,18-24
19050,13750,5300,35,male,25-39
12350,10600,1750,19,male,18-24
9600,8300,1300,18,male,18-24
40250,15200,25050,19,female,18-24
17200,10900,6300,33,Female,25-39
12000,6750,5250,18,male,18-24
9650,7850,1800,20,male,18-24
25800,14100,11700,36,Female,25-39
10250,9200,1050,18,male,18-24
21900,11550,10350,30,male,25-39
28950,16450,12500,19,female,18-24
10400,6100,4300,18,male,18-24
8500,7500,1000,18,male,18-24
22950,12950,10000,26,female,25-39
42100,14750,27350,19,female,18-24
9450,7150,2300,20,male,18-24
22400,19350,3050,18,female,18-24
63550,23150,40400,21,female,18-24
9900,7100,2800,19,male,18-24
9000,8350,650,18,male,18-24
21050,12500,8550,29,FEMALE,25-39
10450,9200,1250,18,male,18-24
12200,7950,4250,18,male,18-24
9450,9450,0,18,male,18-24
9750,10500,-750,18,male,18-24
45300,17350,27950,19,female,18-24
34150,25450,8700,21,female,18-24
28300,12300,16000,34,Female,25-39
15150,13600,1550,28,male,25-39
6200,8400,-2200,19,male,18-24
12750,8600,4150,25,male,25-39
37750,15150,22600,18,female,18-24
8300,7850,450,18,male,18-24
19000,13200,5800,26,female,25-39
13150,10550,2600,18,male,18-24
8850,8050,800,18,male,18-24
133450,31400,102050,21,male,18-24
118150,36600,81550,21,male,18-24
16500,9950,6550,31,male,25-39
31850,12450,19400,18,female,18-24
47150,16450,30700,19,female,18-24
37700,14250,23450,18,female,18-24
10600,8450,2150,18,male,18-24
8900,5700,3200,20,male,18-24
12850,8650,4200,18,male,18-24
45250,15300,29950,19,female,18-24
26200,11200,15000,27,female,25-39
13750,10500,3250,27,male,25-39
19500,9450,10050,29,FEMALE,25-39
10000,8100,1900,19,male,18-24
46400,27600,18800,24,female,18-24
47800,21950,25850,21,female,18-24
53100,11300,41800,18,female,18-24
111800,40300,71500,21,male,18-24
9700,7000,2700,19,male,18-24
9650,9900,-250,42,male,40+
8100,8650,-550,20,male,18-24
7850,7850,0,20,male,18-24
9200,8400,800,18,male,18-24
11900,7700,4200,18,male,18-24
8500,8950,-450,18,male,18-24
19450,13100,6350,34,Female,25-39
20700,11700,9000,29,FEMALE,25-39
41800,13000,28800,19,female,18-24
51700,21000,30700,22,female,18-24
102750,36500,66250,21,male,18-24
8400,8550,-150,19,male,18-24
40700,13600,27100,19,female,18-24
48050,16150,31900,18,female,18-24
10150,9000,1150,18,male,18-24
14100,8350,5750,19,male,18-24
10750,7650,3100,18,male,18-24
10100,6300,3800,19,male,18-24
27700,12250,15450,30,Female,25-39
8950,5950,3000,18,male,18-24
17000,13250,3750,27,male,25-39
46950,11600,35350,19,female,18-24
11900,8300,3600,20,male,18-24
39400,13800,25600,18,female,18-24
9050,9600,-550,18,male,18-24
12500,7250,5250,18,male,18-24
12950,8650,4300,20,male,18-24
122750,40600,82150,21,male,18-24
8300,7850,450,18,male,18-24
26050,10900,15150,31,Female,25-39
23250,14100,9150,31,male,25-39
9550,9000,550,19,male,18-24
8750,7950,800,20,male,18-24
13300,7750,5550,18,male,18-24
10450,9250,1200,20,male,18-24
8250,8350,-100,18,male,18-24
9200,7400,1800,18,male,18-24
11550,8000,3550,18,male,18-24
27650,10650,17000,36,Female,25-39
54850,21250,33600,21,female,18-24
32800,14550,18250,19,female,18-24
8800,6800,2000,18,male,18-24
10400,8350,2050,18,male,18-24
11150,9300,1850,18,male,18-24
33150,16400,16750,19,female,18-24
50900,15300,35600,18,female,18-24
127700,41650,86050,21,male,18-24
107300,34300,73000,23,male,18-24
8900,7700,1200,18,male,18-24
7500,7300,200,20,male,18-24
34450,17150,17300,18,female,18-24
26750,13050,13700,36,male,25-39
20050,13150,6900,33,male,25-39
6450,8600,-2150,19,male,18-24
7650,9100,-1450,18,male,18-24
7100,7900,-800,19,male,18-24
51950,25250,26700,22,female,18-24
7150,8050,-900,18,male,18-24
37600,11600,26000,18,female,18-24
11100,8500,2600,18,male,18-24
7700,7400,300,20,male,18-24
23650,19750,3900,18,female,18-24
9500,6700,2800,20,male,18-24
9000,7200,1800,20,male,18-24
10400,8050,2350,19,male,18-24
54550,12450,42100,18,female,18-24
20300,15050,5250,36,male,25-39
9450,8250,1200,19,male,18-24
9150,9500,-350,40,male,40+
55100,19750,35350,21,female,18-24
51650,20750,30900,22,female,18-24
9300,7200,2100,18,male,18-24
13850,6350,7500,19,male,18-24
17300,12600,4700,37,Female,25-39
20000,9850,10150,31,Female,25-39
119550,43000,76550,21,male,18-24
9750,8800,950,19,male,18-24
18200,13950,4250,36,Female,25-39
18700,14500,4200,32,Female,25-39
14050,13350,700,33,Female,25-39
11500,8550,2950,20,male,18-24
45700,22850,22850,22,female,18-24
8100,8150,-50,20,male,18-24
57600,17350,40250,21,female,18-24
22900,11350,11550,27,female,25-39
16450,15250,1200,25,female,25-39
12100,7400,4700,18,male,18-24
12250,8550,3700,19,male,18-24
42700,18300,24400,18,female,18-24
10900,6900,4000,19,male,18-24
9650,7950,1700,18,male,18-24
31900,20300,11600,18,female,18-24
9400,7950,1450,18,male,18-24
8900,7550,1350,18,male,18-24
12200,8900,3300,18,male,18-24
50500,15600,34900,21,female,18-24
31350,16150,15200,19,female,18-24
14550,10950,3600,29,FEMALE,25-39
20200,14500,5700,34,Female,25-39
54950,22300,32650,22,female,18-24
18450,11800,6650,37,Female,25-39
8850,7500,1350,19,male,18-24
40200,18500,21700,21,female,18-24
22650,12050,10600,38,Female,25-39
10850,11750,-900,40,female,40+
9300,8600,700,18,male,18-24
38100,17350,20750,19,female,18-24
39300,11900,27400,18,female,18-24
12950,8700,4250,20,male,18-24
9650,10400,-750,46,female,40+
54000,12500,41500,18,female,18-24
34100,7100,27000,19,female,18-24
41200,14550,26650,18,female,18-24
9550,9350,200,18,male,18-24
26050,11400,14650,37,male,25-39
7400,8000,-600,18,male,18-24
9950,6600,3350,18,male,18-24
10250,6200,4050,20,male,18-24
16750,8550,8200,20,male,18-24
17100,16500,600,25,male,25-39
116550,44300,72250,21,male,18-24
110550,44950,65600,24,male,18-24
17000,12200,4800,27,female,25-39
20850,10000,10850,28,female,25-39
13650,8250,5400,18,male,18-24
10150,7700,2450,18,male,18-24
22050,11950,10100,30,FEMALE,25-39
8650,8050,600,18,male,18-24
39300,7650,31650,19,female,18-24
25600,14600,11000,18,female,18-24
11100,8300,2800,18,male,18-24
16700,14750,1950,31,Female,25-39
16700,13850,2850,29,male,25-39
8050,9500,-1450,19,male,18-24
49000,16800,32200,18,female,18-24
45100,16800,28300,19,female,18-24
43850,16450,27400,19,female,18-24
10400,7850,2550,19,male,18-24
119600,32400,87200,22,male,18-24
41450,10400,31050,19,female,18-24
44100,16200,27900,19,female,18-24
14000,15600,-1600,36,male,25-39
17300,11900,5400,33,Female,25-39
47000,18300,28700,21,female,18-24
110850,38850,72000,21,male,18-24
39600,19350,20250,18,female,18-24
7350,5350,2000,18,male,18-24
9600,8150,1450,18,male,18-24
10200,7500,2700,20,male,18-24
16750,11250,5500,28,female,25-39
23000,10750,12250,27,male,25-39
57400,22850,34550,22,female,18-24
9550,5600,3950,20,male,18-24
131750,41100,90650,21,male,18-24
15900,7000,8900,18,male,18-24
15150,9900,5250,27,female,25-39
39550,17750,21800,24,female,18-24
28100,15850,12250,18,female,18-24
36150,13950,22200,19,female,18-24
19100,10500,8600,34,Female,25-39
10200,7500,2700,20,male,18-24
39250,13650,25600,19,female,18-24
9150,7500,1650,19,male,18-24
39000,14250,24750,18,female,18-24
18600,11050,7550,26,female,25-39
46750,16500,30250,18,female,18-24
55550,27050,28500,22,female,18-24
39850,14600,25250,20,female,18-24
16550,15300,1250,27,male,25-39
108200,38200,70000,21,male,18-24
11600,8400,3200,19,male,18-24
50400,19000,31400,24,female,18-24
40300,14900,25400,18,female,18-24
44150,13750,30400,23,female,18-24
6350,8900,-2550,19,male,18-24
45250,13950,31300,18,female,18-24
6850,9050,-2200,19,male,18-24
11350,7900,3450,18,male,18-24
43600,17650,25950,19,female,18-24
9050,8650,400,18,male,18-24
27000,11550,15450,29,male,25-39
20950,9350,11600,27,male,25-39
10100,9550,550,19,male,18-24
9550,8100,1450,19,male,18-24
43550,18000,25550,19,female,18-24
7100,5900,1200,18,male,18-24
112500,42150,70350,21,male,18-24
18500,12100,6400,25,male,25-39
22500,10350,12150,31,male,25-39
9950,7450,2500,33,Female,25-39
21650,13600,8050,32,Female,25-39
10950,8400,2550,18,male,18-24
42950,14000,28950,19,female,18-24
9100,8850,250,19,male,18-24
24650,7550,17100,34,male,25-39
9000,11050,-2050,19,male,18-24
19500,10900,8600,38,Female,25-39
24700,13750,10950,27,female,25-39
8150,8900,-750,18,male,18-24
8950,7000,1950,20,male,18-24
18600,11400,7200,35,male,25-39
6950,9400,-2450,20,male,18-24
11200,7650,3550,18,male,18-24
39250,15400,23850,19,female,18-24
49600,13550,36050,18,female,18-24
20300,12750,7550,29,FEMALE,25-39
9700,6900,2800,18,male,18-24
10600,10250,350,40,female,40+
60750,14250,46500,18,female,18-24
8650,7300,1350,18,male,18-24
15000,7100,7900,18,male,18-24
9950,7500,2450,19,male,18-24
8900,9300,-400,19,male,18-24
20350,12700,7650,27,female,25-39
9750,8050,1700,18,male,18-24
14150,7700,6450,20,male,18-24
12150,10850,1300,28,FEMALE,25-39
22550,13550,9000,35,Female,25-39
18350,14650,3700,30,male,25-39
20750,14850,5900,32,Female,25-39
38750,12400,26350,19,female,18-24
120550,36900,83650,21,male,18-24
6650,7850,-1200,19,male,18-24
22250,7450,14800,35,male,25-39
51650,19150,32500,20,female,18-24
7900,9200,-1300,19,male,18-24
40950,10150,30800,20,female,18-24
38650,11500,27150,18,female,18-24
53600,20600,33000,24,female,18-24
16550,11100,5450,31,Female,25-39
10400,8850,1550,18,male,18-24
56150,12750,43400,18,female,18-24
13350,7100,6250,18,male,18-24
22100,12300,9800,27,male,25-39
51550,21650,29900,18,female,18-24
9000,8650,350,20,male,18-24
9900,9250,650,19,male,18-24
12000,8250,3750,18,male,18-24
12350,7700,4650,20,male,18-24
126750,40350,86400,21,male,18-24
65150,19500,45650,22,female,18-24
11550,9950,1600,46,female,40+
8450,8000,450,20,male,18-24
51600,15250,36350,21,female,18-24
12500,9550,2950,19,male,18-24
16050,12600,3450,26,male,25-39
19850,13000,6850,32,male,25-39
18050,14100,3950,33,male,25-39
12850,8100,4750,18,male,18-24
19550,12900,6650,35,male,25-39
9700,8050,1650,18,male,18-24
10300,8250,2050,19,male,18-24
11500,8650,2850,18,male,18-24
33700,11500,22200,19,female,18-24
44050,14950,29100,19,female,18-24
28100,13200,14900,30,male,25-39
13000,14400,-1400,30,male,25-39
40800,19150,21650,18,female,18-24
14000,11750,2250,30,male,25-39
7500,8700,-1200,18,male,18-24
25900,10000,15900,38,Female,25-39
55650,17950,37700,21,female,18-24
38600,14300,24300,18,female,18-24
10400,8700,1700,18,male,18-24
12850,6400,6450,20,male,18-24
30400,17000,13400,18,female,18-24
39000,25000,14000,24,female,18-24
36750,12400,24350,18,female,18-24
19150,15300,3850,33,Female,25-39
48250,14950,33300,22,female,18-24
10650,6900,3750,18,male,18-24
42350,21000,21350,19,female,18-24
42900,15850,27050,18,female,18-24
108700,37450,71250,21,male,18-24
46650,19250,27400,20,female,18-24
106450,46900,59550,24,male,18-24
7200,8550,-1350,18,male,18-24
20800,11250,9550,37,male,25-39
39350,9500,29850,18,female,18-24
45050,20100,24950,24,female,18-24
8550,7650,900,18,male,18-24
25650,11750,13900,29,FEMALE,25-39
7200,9100,-1900,19,male,18-24
12050,8600,3450,20,male,18-24
10700,10100,600,18,male,18-24
45850,13000,32850,18,female,18-24
10700,8550,2150,18,male,18-24
48050,16250,31800,18,female,18-24
11300,9000,2300,19,male,18-24
13000,9950,3050,18,male,18-24
9750,6550,3200,20,male,18-24
42200,18550,23650,18,female,18-24
20250,12350,7900,27,male,25-39
43600,19600,24000,18,female,18-24
8150,8350,-200,19,male,18-24
27750,10150,17600,28,FEMALE,25-39
42600,17050,25550,19,female,18-24
18300,11700,6600,29,male,25-39
28450,12250,16200,18,female,18-24
44200,14200,30000,18,female,18-24
25950,12350,13600,27,male,25-39
30950,17300,13650,19,female,18-24
9300,8600,700,18,male,18-24
37650,24100,13550,21,female,18-24
49250,19600,29650,24,female,18-24
32000,14950,17050,19,female,18-24
10750,7550,3200,19,male,18-24
41200,14800,26400,23,female,18-24
9350,6900,2450,19,male,18-24
23400,10600,12800,26,male,25-39
15850,8400,7450,27,female,25-39
118350,36950,81400,22,male,18-24
47200,13600,33600,18,female,18-24
10400,14650,-4250,30,FEMALE,25-39
50050,19850,30200,23,female,18-24
131400,43700,87700,23,male,18-24
9950,9200,750,42,female,40+
10750,8050,2700,20,male,18-24
41650,16150,25500,19,female,18-24
123450,39750,83700,24,male,18-24
9850,8450,1400,18,male,18-24
22150,10250,11900,32,Female,25-39
56350,23800,32550,23,female,18-24
20200,13950,6250,32,male,25-39
7400,8750,-1350,19,male,18-24
7350,14350,-7000,28,FEMALE,25-39
19700,12400,7300,28,male,25-39
6050,5800,250,18,male,18-24
13950,8250,5700,18,male,18-24
8400,7200,1200,19,male,18-24
7750,9200,-1450,18,male,18-24
6500,8050,-1550,18,male,18-24
13050,8100,4950,18,male,18-24
22300,12100,10200,33,Female,25-39
29400,15700,13700,19,female,18-24
40150,15400,24750,18,female,18-24
10500,7950,2550,18,male,18-24
40600,26050,14550,21,female,18-24
9100,7450,1650,18,male,18-24
15800,8500,7300,18,male,18-24
53900,15900,38000,18,female,18-24
18400,15550,2850,32,Female,25-39
9500,5650,3850,20,male,18-24
7050,9250,-2200,19,male,18-24
19750,12200,7550,25,male,25-39
11800,6800,5000,20,male,18-24
29850,18100,11750,18,female,18-24
18650,13800,4850,35,Female,25-39
140400,47400,93000,21,male,18-24
11650,7200,4450,18,male,18-24
11850,6450,5400,18,male,18-24
12700,8850,3850,18,male,18-24
9650,9000,650,19,male,18-24
34100,12100,22000,19,female,18-24
17650,11650,6000,26,male,25-39
10650,6450,4200,18,male,18-24
123950,45150,78800,21,male,18-24
27150,11150,16000,38,male,25-39
7950,8400,-450,19,male,18-24
9200,8550,650,18,male,18-24
9800,8350,1450,18,male,18-24
13150,6250,6900,20,male,18-24
41950,21600,20350,19,female,18-24
18850,15050,3800,32,Female,25-39
107850,38350,69500,22,male,18-24
18900,9750,9150,28,FEMALE,25-39
18350,14200,4150,33,male,25-39
11900,8350,3550,19,male,18-24
11600,8150,3450,19,male,18-24
35700,13100,22600,19,female,18-24
51150,20900,30250,22,female,18-24
40900,18400,22500,21,female,18-24
11050,7700,3350,20,male,18-24
12200,6550,5650,18,male,18-24
11750,6450,5300,18,male,18-24
23500,8600,14900,29,FEMALE,25-39
43350,18750,24600,18,female,18-24
8050,6200,1850,19,male,18-24
29650,12150,17500,25,female,25-39
46700,12800,33900,18,female,18-24
124700,45950,78750,21,male,18-24
17050,10900,6150,32,Female,25-39
43900,19100,24800,19,female,18-24
10550,11400,-850,40,female,40+
10750,8050,2700,18,male,18-24
101550,39900,61650,21,male,18-24
20050,12600,7450,27,male,25-39
9350,7100,2250,18,male,18-24
56400,14600,41800,19,female,18-24
14400,12150,2250,28,male,25-39
22300,11700,10600,34,male,25-39
10850,8900,1950,18,male,18-24
23000,11200,11800,33,Female,25-39
11150,8200,2950,19,male,18-24
29400,18950,10450,19,female,18-24
11000,8800,2200,18,male,18-24
44100,20850,23250,22,female,18-24
10800,7600,3200,19,male,18-24
8950,8750,200,18,male,18-24
21600,13450,8150,25,female,25-39
9350,7250,2100,19,male,18-24
12600,7550,5050,18,male,18-24
62550,15850,46700,22,female,18-24
5650,7750,-2100,20,male,18-24
113800,41350,72450,23,male,18-24
11250,7450,3800,20,male,18-24
31250,15450,15800,18,female,18-24
10700,11300,-600,42,female,40+
9450,9350,100,20,male,18-24
11050,6550,4500,18,male,18-24
13950,8600,5350,19,male,18-24
18850,12500,6350,31,male,25-39
111650,39600,72050,22,male,18-24
19700,14350,5350,19,female,18-24
20850,12150,8700,18,female,18-24
46900,16350,30550,19,female,18-24
120650,33400,87250,23,male,18-24
12500,7500,5000,18,male,18-24
19750,8850,10900,36,Female,25-39
11150,7300,3850,19,male,18-24
105200,40200,65000,21,male,18-24
10800,5250,5550,18,male,18-24
10350,9350,1000,19,male,18-24
48700,16150,32550,18,female,18-24
51350,15250,36100,21,female,18-24
8400,7900,500,18,male,18-24
50450,17850,32600,18,female,18-24
21650,11400,10250,38,Female,25-39
17850,9350,8500,36,male,25-39
50350,15450,34900,20,female,18-24
12900,12250,650,37,Female,25-39
12550,7150,5400,18,male,18-24
42250,18000,24250,18,female,18-24
32850,15950,16900,21,female,18-24
17400,8100,9300,31,Female,25-39
64450,20300,44150,22,female,18-24
12600,7500,5100,18,male,18-24
19800,12400,7400,34,male,25-39
17100,14450,2650,37,male,25-39
56050,12700,43350,18,female,18-24
50850,21150,29700,21,female,18-24
42500,18600,23900,18,female,18-24
14000,7500,6500,19,male,18-24
25450,11550,13900,27,female,25-39
47950,16200,31750,18,female,18-24
11050,8700,2350,18,male,18-24
37800,16400,21400,19,female,18-24
12150,6900,5250,18,male,18-24
21100,18150,2950,18,female,18-24
111450,35900,75550,21,male,18-24
16850,12950,3900,29,FEMALE,25-39
41050,16300,24750,18,female,18-24
9800,8550,1250,18,male,18-24
41950,7900,34050,19,female,18-24
50250,13450,36800,19,female,18-24
14300,8250,6050,19,male,18-24
42250,18900,23350,19,female,18-24
48250,12050,36200,18,female,18-24
13050,7350,5700,19,male,18-24
10300,6100,4200,19,male,18-24
37500,11750,25750,18,female,18-24
125200,40650,84550,21,male,18-24
37300,15350,21950,19,female,18-24
41850,20400,21450,18,female,18-24
20750,10350,10400,30,male,25-39
26500,12150,14350,25,male,25-39
15550,12650,2900,28,female,25-39
19850,10700,9150,39,Female,25-39
20850,10100,10750,27,female,25-39
57100,19500,37600,22,female,18-24
12150,8800,3350,19,male,18-24
23500,11000,12500,28,male,25-39
23900,13100,10800,25,female,25-39
22350,10950,11400,32,male,25-39
44600,20500,24100,24,female,18-24
10450,8050,2400,18,male,18-24
47150,7650,39500,19,female,18-24
49200,18250,30950,18,female,18-24
20700,12800,7900,25,male,25-39
12750,7850,4900,18,male,18-24
10100,8200,1900,18,male,18-24
9050,7500,1550,18,male,18-24
8900,8650,250,18,male,18-24
22000,8700,13300,25,female,25-39
25250,10450,14800,35,Female,25-39
37200,16600,20600,18,female,18-24
22100,10750,11350,32,Female,25-39
49550,14400,35150,19,female,18-24
17900,12850,5050,26,female,25-39
15900,13400,2500,30,FEMALE,25-39
25100,17750,7350,18,female,18-24
12850,8900,3950,20,male,18-24
38150,16250,21900,18,female,18-24
9050,10650,-1600,40,female,40+
37650,12750,24900,19,female,18-24
8700,8250,450,19,male,18-24
11300,10400,900,18,male,18-24
9850,7000,2850,18,male,18-24
109650,39500,70150,21,male,18-24
20900,7200,13700,26,male,25-39
16700,12350,4350,34,male,25-39
53550,22850,30700,22,female,18-24
51850,14250,37600,21,female,18-24
50500,13800,36700,18,female,18-24
19500,10850,8650,38,Female,25-39
10300,8750,1550,18,male,18-24
10100,7700,2400,19,male,18-24
10950,8250,2700,18,male,18-24
28100,24000,4100,19,female,18-24
22200,14550,7650,26,female,25-39
56100,17900,38200,18,female,18-24
8850,7850,1000,18,male,18-24
12000,6900,5100,19,male,18-24
22050,13400,8650,26,female,25-39
12550,8650,3900,20,male,18-24
40400,14300,26100,18,female,18-24
25300,11950,13350,35,Female,25-39
10150,7750,2400,19,male,18-24
9550,9000,550,19,male,18-24
126450,46300,80150,23,male,18-24
38250,11700,26550,19,female,18-24
42150,15650,26500,18,female,18-24
5000,7100,-2100,19,male,18-24
10500,7400,3100,20,male,18-24
18450,10900,7550,30,FEMALE,25-39
9950,8600,1350,19,male,18-24
21850,11550,10300,27,female,25-39
11050,7200,3850,18,male,18-24
6700,7600,-900,18,male,18-24
13800,7500,6300,19,male,18-24
20250,8600,11650,32,male,25-39
23950,13450,10500,30,male,25-39
22150,9300,12850,28,male,25-39
33950,9800,24150,18,female,18-24
50850,13550,37300,18,female,18-24
8400,7800,600,19,male,18-24
55700,14950,40750,18,female,18-24
43600,16250,27350,18,female,18-24
40150,9150,31000,18,female,18-24
10650,7500,3150,18,male,18-24
21150,11700,9450,31,Female,25-39
54200,18400,35800,18,female,18-24
11400,8050,3350,19,male,18-24
24150,9900,14250,33,Female,25-39
34800,13100,21700,19,female,18-24
51450,23000,28450,21,female,18-24
9350,9100,250,18,male,18-24
21450,12150,9300,35,Female,25-39
34700,20600,14100,18,female,18-24
49500,21350,28150,22,female,18-24
36750,9350,27400,18,female,18-24
56700,16250,40450,22,female,18-24
9900,7800,2100,19,male,18-24
7300,7950,-650,20,male,18-24
19500,10600,8900,26,male,25-39
8600,7600,1000,18,male,18-24
17450,12650,4800,37,male,25-39
23100,10200,12900,33,male,25-39
43500,10450,33050,19,female,18-24
10900,8350,2550,18,male,18-24
71300,20400,50900,18,female,18-24
13050,9050,4000,19,male,18-24
19850,13200,6650,32,Female,25-39
46150,12400,33750,18,female,18-24
15850,10700,5150,25,female,25-39
69100,23650,45450,21,female,18-24
40300,13650,26650,18,female,18-24
23750,14700,9050,30,male,25-39
49900,22650,27250,21,female,18-24
8550,7900,650,20,male,18-24
19250,7800,11450,27,male,25-39
46050,15950,30100,19,female,18-24
8500,7650,850,18,male,18-24
39550,15850,23700,19,female,18-24
24400,11550,12850,26,female,25-39
38350,14600,23750,19,female,18-24
10650,11650,-1000,41,female,40+
21950,20500,1450,18,female,18-24
21950,11100,10850,27,female,25-39
22000,11450,10550,27,male,25-39
22000,11700,10300,27,female,25-39
10900,6050,4850,18,male,18-24
8300,8800,-500,18,male,18-24
7850,8150,-300,18,male,18-24
13050,7000,6050,19,male,18-24
7500,5900,1600,18,male,18-24
55800,14950,40850,21,female,18-24
10100,8050,2050,18,male,18-24
11500,8950,2550,19,male,18-24
135650,43450,92200,21,male,18-24
12250,8450,3800,18,male,18-24
22750,13400,9350,18,female,18-24
20700,10750,9950,27,female,25-39
11100,6700,4400,18,male,18-24
10300,5900,4400,20,male,18-24
19500,10350,9150,25,female,25-39
8800,11500,-2700,40,male,40+
33550,14550,19000,19,female,18-24
11650,6750,4900,18,male,18-24
5700,8750,-3050,20,male,18-24
66950,24800,42150,21,female,18-24
21100,12900,8200,34,Female,25-39
38550,14950,23600,18,female,18-24
51150,13200,37950,18,female,18-24
13450,9600,3850,19,male,18-24
21000,10900,10100,33,male,25-39
7350,5800,1550,18,male,18-24
44050,18050,26000,22,female,18-24
108850,36500,72350,22,male,18-24
22800,11850,10950,32,Female,25-39
62250,10250,52000,18,female,18-24
13850,7900,5950,19,male,18-24
8250,8100,150,19,male,18-24
10500,8050,2450,20,male,18-24
24900,13100,11800,34,Female,25-39
9150,7750,1400,19,male,18-24
30650,16400,14250,19,female,18-24
17250,10100,7150,33,male,25-39
16650,12600,4050,26,female,25-39
19450,10150,9300,35,Female,25-39
12900,8850,4050,19,male,18-24
8800,7950,850,18,male,18-24
52300,16300,36000,21,female,18-24
43250,15150,28100,18,female,18-24
20750,9750,11000,29,male,25-39
8500,6450,2050,18,male,18-24
17300,13400,3900,25,male,25-39
29550,17900,11650,19,female,18-24
36400,13000,23400,19,female,18-24
40300,24150,16150,24,female,18-24
11500,8750,2750,20,male,18-24
18700,11950,6750,34,male,25-39
12050,7950,4100,19,male,18-24
4750,8850,-4100,19,male,18-24
11000,7400,3600,19,male,18-24
20650,12000,8650,32,Female,25-39
43900,15900,28000,19,female,18-24
67050,16600,50450,24,female,18-24
20000,11400,8600,26,male,25-39
15950,11450,4500,27,male,25-39
20700,14250,6450,36,Female,25-39
22950,15750,7200,18,female,18-24
9850,8400,1450,20,male,18-24
23050,11350,11700,25,female,25-39
13350,9350,4000,20,male,18-24
53100,23650,29450,21,female,18-24
35150,16850,18300,18,female,18-24
121350,36750,84600,23,male,18-24
21300,13550,7750,31,male,25-39
15850,13900,1950,25,female,25-39
7200,11100,-3900,18,male,18-24
6950,7850,-900,18,male,18-24
54550,14050,40500,18,female,18-24
13450,7700,5750,20,male,18-24
15350,8450,6900,30,male,25-39
41600,26150,15450,22,female,18-24
129850,49100,80750,21,male,18-24
9400,8150,1250,20,male,18-24
127450,47900,79550,23,male,18-24
45050,17900,27150,19,female,18-24
22300,10100,12200,31,Female,25-39
6700,6750,-50,20,male,18-24
21050,7250,13800,29,male,25-39
25150,13150,12000,19,female,18-24
6000,8000,-2000,20,male,18-24
33600,19050,14550,18,female,18-24
6250,9150,-2900,18,male,18-24
16350,10850,5500,27,female,25-39
20650,10100,10550,29,male,25-39
24750,11100,13650,27,female,25-39
21650,11650,10000,29,male,25-39
10800,7250,3550,18,male,18-24
9150,9400,-250,18,male,18-24
10350,8100,2250,19,male,18-24
43800,22800,21000,21,female,18-24
47500,19700,27800,21,female,18-24
118850,46100,72750,21,male,18-24
10450,7650,2800,18,male,18-24
47200,16450,30750,18,female,18-24
48850,15700,33150,22,female,18-24
9950,7350,2600,18,male,18-24
30800,6800,24000,18,female,18-24
9600,9350,250,20,male,18-24
43650,15600,28050,18,female,18-24
18400,13150,5250,32,Female,25-39
10300,6550,3750,19,male,18-24
10500,6950,3550,19,male,18-24
26650,12450,14200,27,male,25-39
11150,8500,2650,19,male,18-24
30050,18950,11100,19,female,18-24
30750,16050,14700,18,female,18-24
23350,12900,10450,25,female,25-39
44200,17750,26450,18,female,18-24
26500,15350,11150,27,male,25-39
9400,9400,0,18,male,18-24
124250,36650,87600,21,male,18-24
9850,9250,600,19,male,18-24
51850,24500,27350,21,female,18-24
58000,14750,43250,22,female,18-24
25050,13350,11700,27,male,25-39
46200,18950,27250,24,female,18-24
41150,13900,27250,18,female,18-24
6200,7800,-1600,18,male,18-24
18500,13750,4750,35,male,25-39
37050,17800,19250,18,female,18-24
22700,15550,7150,25,female,25-39
109100,42750,66350,21,male,18-24
8200,7850,350,19,male,18-24
15400,11050,4350,33,Female,25-39
41350,16200,25150,19,female,18-24
49350,22750,26600,21,female,18-24
9450,9100,350,18,male,18-24
34500,16900,17600,18,female,18-24
9450,6850,2600,18,male,18-24
34600,14250,20350,18,female,18-24
18200,11500,6700,30,male,25-39
10500,9750,750,18,male,18-24
7700,9850,-2150,19,male,18-24
36700,22450,14250,21,female,18-24
28000,10200,17800,26,female,25-39
25950,13550,12400,25,female,25-39
7200,9750,-2550,18,male,18-24
11350,7650,3700,19,male,18-24
51800,23150,28650,22,female,18-24
47450,14900,32550,18,female,18-24
33400,12300,21100,18,female,18-24
8650,7650,1000,20,male,18-24
11150,9150,2000,18,male,18-24
30100,11400,18700,18,female,18-24
24000,10400,13600,38,Female,25-39
36950,13300,23650,18,female,18-24
9450,10350,-900,20,male,18-24
6350,8000,-1650,19,male,18-24
14350,8000,6350,19,male,18-24
51800,23950,27850,24,female,18-24
21400,11350,10050,30,male,25-39
41600,13950,27650,18,female,18-24
13650,8700,4950,18,male,18-24
6450,7100,-650,19,male,18-24
22250,11700,10550,35,Female,25-39
9300,7350,1950,20,male,18-24
55450,26600,28850,21,female,18-24
49350,8800,40550,19,female,18-24
25350,10050,15300,25,male,25-39
25700,21000,4700,34,Female,25-39
12600,10000,2600,18,male,18-24
12300,9150,3150,18,male,18-24
21800,11700,10100,25,female,25-39
18250,11150,7100,29,FEMALE,25-39
10450,5150,5300,19,male,18-24
21900,13000,8900,36,Female,25-39
11550,9400,2150,18,male,18-24
12650,15050,-2400,27,female,25-39
11250,8000,3250,18,male,18-24
7000,8000,-1000,18,male,18-24
20950,11100,9850,33,Female,25-39
121000,30300,90700,23,male,18-24
23200,13900,9300,32,Female,25-39
29700,11200,18500,19,female,18-24
22450,12850,9600,31,male,25-39
48200,14500,33700,19,female,18-24
22850,10550,12300,25,male,25-39
50400,15750,34650,19,female,18-24
8000,9600,-1600,20,male,18-24
48950,24150,24800,23,female,18-24
10350,8450,1900,18,male,18-24
143000,39600,103400,21,male,18-24
25500,12450,13050,29,FEMALE,25-39
11600,7900,3700,19,male,18-24
38850,14900,23950,18,female,18-24
49450,16200,33250,19,female,18-24
13000,10600,2400,33,male,25-39
14600,10700,3900,28,FEMALE,25-39
11150,7250,3900,18,male,18-24
10900,7450,3450,18,male,18-24
18600,11200,7400,25,female,25-39
45950,14650,31300,18,female,18-24
18450,13100,5350,32,male,25-39
10350,7450,2900,19,male,18-24
9400,8150,1250,18,male,18-24
5900,6450,-550,19,male,18-24
6950,6850,100,19,male,18-24
11650,15550,-3900,29,FEMALE,25-39
7950,7250,700,18,male,18-24
46400,11350,35050,19,female,18-24
11350,11500,-150,40,female,40+
9200,11550,-2350,42,female,40+
25350,16250,9100,36,Female,25-39
13300,8050,5250,19,male,18-24
118450,39550,78900,21,male,18-24
8650,6900,1750,18,male,18-24
9850,7900,1950,19,male,18-24
18800,17250,1550,26,male,25-39
25100,13600,11500,26,male,25-39
119150,42750,76400,21,male,18-24
11150,7450,3700,18,male,18-24
7450,7250,200,19,male,18-24
20350,12400,7950,32,Female,25-39
20950,10450,10500,29,male,25-39
9950,8000,1950,18,male,18-24
41850,14750,27100,18,female,18-24
19500,12900,6600,26,male,25-39
11250,5750,5500,18,male,18-24
33400,12950,20450,18,female,18-24
37300,12200,25100,19,female,18-24
56400,19450,36950,19,female,18-24
25050,12400,12650,30,FEMALE,25-39
16100,8950,7150,28,male,25-39
9300,8250,1050,19,male,18-24
22300,10800,11500,32,male,25-39
6300,8050,-1750,19,male,18-24
9150,7150,2000,20,male,18-24
19100,11150,7950,33,male,25-39
36750,10000,26750,19,female,18-24
21050,14300,6750,25,female,25-39
8250,8500,-250,20,male,18-24
19900,10500,9400,36,Female,25-39
39000,15300,23700,19,female,18-24
6750,8100,-1350,18,male,18-24
19950,11350,8600,28,male,25-39
26950,11450,15500,19,female,18-24
33050,18100,14950,19,female,18-24
13350,8150,5200,20,male,18-24
9100,5700,3400,20,male,18-24
20200,13800,6400,34,Female,25-39
42250,15550,26700,18,female,18-24
11000,8400,2600,18,male,18-24
33850,12950,20900,19,female,18-24
9500,6850,2650,18,male,18-24
7400,5850,1550,19,male,18-24
124050,41550,82500,21,male,18-24
8700,7500,1200,18,male,18-24
8200,6450,1750,18,male,18-24
17600,12100,5500,27,female,25-39
32500,16000,16500,18,female,18-24
36600,16950,19650,18,female,18-24
9750,7600,2150,19,male,18-24
15250,12050,3200,29,FEMALE,25-39
53000,21100,31900,21,female,18-24
47550,12700,34850,18,female,18-24
42200,20250,21950,22,female,18-24
21900,11700,10200,36,Female,25-39
8100,4800,3300,20,male,18-24
32850,13500,19350,19,female,18-24
47250,20900,26350,21,female,18-24
24850,14100,10750,33,Female,25-39
43050,13750,29300,19,female,18-24
42550,13500,29050,18,female,18-24
43450,15900,27550,19,female,18-24
11700,5850,5850,18,male,18-24
27450,18750,8700,19,female,18-24
37950,16300,21650,18,female,18-24
24200,10000,14200,31,male,25-39
18150,13800,4350,33,Female,25-39
7400,7800,-400,19,male,18-24
38800,10400,28400,18,female,18-24
63100,11450,51650,21,female,18-24
48400,16450,31950,22,female,18-24
36550,18650,17900,18,female,18-24
21250,13150,8100,38,Female,25-39
15750,13700,2050,33,male,25-39
49350,18600,30750,18,female,18-24
126700,36900,89800,23,male,18-24
42950,21500,21450,21,female,18-24
20100,9800,10300,31,male,25-39
35300,18150,17150,18,female,18-24
10750,7500,3250,19,male,18-24
22650,12600,10050,25,female,25-39
10000,9450,550,18,male,18-24
11400,7950,3450,18,male,18-24
52950,21850,31100,21,female,18-24
21950,13750,8200,31,male,25-39
11350,7850,3500,18,male,18-24
7100,6350,750,18,male,18-24
35600,7450,28150,18,female,18-24
6550,8450,-1900,20,male,18-24
6950,7850,-900,18,male,18-24
106550,36400,70150,22,male,18-24
11600,7650,3950,19,male,18-24
69750,16300,53450,21,female,18-24
41200,9700,31500,18,female,18-24
9700,7100,2600,19,male,18-24
52950,20250,32700,22,female,18-24
19350,11100,8250,20,female,18-24
130550,36600,93950,22,male,18-24
39200,16450,22750,19,female,18-24
5750,7200,-1450,18,male,18-24
48450,15050,33400,18,female,18-24
7150,8400,-1250,19,male,18-24
9300,7600,1700,18,male,18-24
39300,15600,23700,19,female,18-24
10000,8000,2000,18,male,18-24
18700,13650,5050,37,male,25-39
46950,17400,29550,19,female,18-24
18700,12900,5800,34,male,25-39
43900,10850,33050,18,female,18-24
29950,18350,11600,19,female,18-24
47550,11500,36050,18,female,18-24
49750,19550,30200,24,female,18-24
21550,14500,7050,28,male,25-39
10650,8050,2600,20,male,18-24
40000,24400,15600,21,female,18-24
8250,10750,-2500,18,male,18-24
8450,8100,350,39,male,25-39
27950,11950,16000,32,male,25-39
8300,6050,2250,18,male,18-24
14350,13050,1300,26,male,25-39
13800,7800,6000,18,male,18-24
12400,9450,2950,18,male,18-24
18250,14000,4250,26,female,25-39
16450,14550,1900,35,Female,25-39
29850,16000,13850,19,female,18-24
132850,36600,96250,22,male,18-24
36200,17000,19200,18,female,18-24
30450,11200,19250,19,female,18-24
34600,10550,24050,18,female,18-24
20500,12950,7550,39,Female,25-39
11950,8350,3600,18,male,18-24
10600,7500,3100,18,male,18-24
49350,17200,32150,24,female,18-24
50650,21250,29400,24,female,18-24
24000,11450,12550,34,Female,25-39
47900,20050,27850,24,female,18-24
18950,15900,3050,33,Female,25-39
25700,14200,11500,27,female,25-39
38350,17350,21000,19,female,18-24
11950,8000,3950,20,male,18-24
10050,7700,2350,18,male,18-24
41900,16950,24950,19,female,18-24
46000,14100,31900,19,female,18-24
36950,16750,20200,19,female,18-24
9300,8400,900,19,male,18-24
9700,7600,2100,19,male,18-24
8250,8050,200,18,male,18-24
12450,9400,3050,18,male,18-24
9800,6700,3100,18,male,18-24
15000,11100,3900,29,FEMALE,25-39
54350,25450,28900,22,female,18-24
16600,13250,3350,25,female,25-39
11300,8400,2900,19,male,18-24
10150,7700,2450,18,male,18-24
59250,14750,44500,19,female,18-24
10900,8450,2450,18,male,18-24
49800,26300,23500,22,female,18-24
58800,24300,34500,21,female,18-24
10850,7800,3050,19,male,18-24
50550,13950,36600,18,female,18-24
9650,7950,1700,18,male,18-24
25400,13450,11950,26,female,25-39
10650,7350,3300,19,male,18-24
25100,13800,11300,36,Female,25-39
123800,35200,88600,23,male,18-24
8500,8500,0,18,male,18-24
31200,15550,15650,19,female,18-24
12400,8750,3650,19,male,18-24
33350,10850,22500,19,female,18-24
43300,16350,26950,21,female,18-24
10200,9600,600,19,male,18-24
135350,40650,94700,23,male,18-24
25350,12100,13250,33,Female,25-39
11600,6600,5000,19,male,18-24
33700,18350,15350,18,female,18-24
14650,11100,3550,30,male,25-39
30000,15800,14200,19,female,18-24
9800,7700,2100,20,male,18-24
21350,11800,9550,27,female,25-39
10150,6050,4100,18,male,18-24
11650,7450,4200,18,male,18-24
41600,17550,24050,18,female,18-24
11000,6700,4300,20,male,18-24
7800,8350,-550,20,male,18-24
120250,44850,75400,21,male,18-24
25100,10000,15100,37,male,25-39
36900,13250,23650,18,female,18-24
35000,10450,24550,19,female,18-24
46350,14800,31550,18,female,18-24
9700,7050,2650,19,male,18-24
19700,10250,9450,28,FEMALE,25-39
11450,8550,2900,18,male,18-24
33700,12900,20800,18,female,18-24
130150,35750,94400,22,male,18-24
130400,35950,94450,22,male,18-24
11450,8600,2850,19,male,18-24
8800,8100,700,18,male,18-24
7550,8600,-1050,20,male,18-24
7450,6000,1450,19,male,18-24
13150,8600,4550,18,male,18-24
18150,10750,7400,34,Female,25-39
6750,9100,-2350,18,male,18-24
64750,21750,43000,22,female,18-24
33500,11600,21900,18,female,18-24
9850,7750,2100,18,male,18-24
15850,11700,4150,35,Female,25-39
23700,13100,10600,27,female,25-39
38950,14300,24650,18,female,18-24
44700,12100,32600,19,female,18-24
45100,14800,30300,18,female,18-24
18600,10650,7950,30,male,25-39
13000,13700,-700,25,female,25-39
12300,8950,3350,19,male,18-24
36200,11900,24300,18,female,18-24
122300,44850,77450,21,male,18-24
18900,10650,8250,36,Female,25-39
7700,8600,-900,18,male,18-24
15200,11500,3700,34,Female,25-39
32150,21250,10900,19,female,18-24
49800,20450,29350,24,female,18-24
65100,23600,41500,24,female,18-24
41650,15800,25850,18,female,18-24
6700,8100,-1400,18,male,18-24
49900,14800,35100,19,female,18-24
21150,12600,8550,37,male,25-39
13600,9100,4500,20,male,18-24
40950,12500,28450,18,female,18-24
11550,7000,4550,18,male,18-24
44350,11000,33350,18,female,18-24
42650,10350,32300,19,female,18-24
15550,14500,1050,25,female,25-39
43600,26650,16950,21,female,18-24
29250,16500,12750,19,female,18-24
10800,8200,2600,19,male,18-24
8850,6600,2250,18,male,18-24
6200,6950,-750,19,male,18-24
9850,10550,-700,18,male,18-24
38450,19950,18500,18,female,18-24
8700,8500,200,18,male,18-24
35650,15950,19700,18,female,18-24
25050,9950,15100,29,male,25-39
24800,11250,13550,25,female,25-39
12050,6850,5200,19,male,18-24
52350,16950,35400,18,female,18-24
17250,13000,4250,29,FEMALE,25-39
9600,6200,3400,18,male,18-24
10900,7450,3450,20,male,18-24
16500,8600,7900,26,female,25-39
21100,12500,8600,27,male,25-39
44550,27650,16900,21,female,18-24
124100,38250,85850,21,male,18-24
122550,38750,83800,22,male,18-24
35600,19850,15750,18,female,18-24
36050,17950,18100,19,female,18-24
7900,12000,-4100,26,female,25-39
7600,6850,750,20,male,18-24
129000,39900,89100,21,male,18-24
38500,18800,19700,18,female,18-24
52050,17000,35050,19,female,18-24
25750,9150,16600,32,Female,25-39
10800,9150,1650,20,male,18-24
32550,11000,21550,19,female,18-24
14050,8700,5350,20,male,18-24
23250,18300,4950,20,female,18-24
8300,6850,1450,18,male,18-24
24500,11350,13150,33,Female,25-39
19900,11500,8400,25,male,25-39
8000,8800,-800,20,male,18-24
7050,8650,-1600,20,male,18-24
50450,16800,33650,22,female,18-24
9800,7200,2600,20,male,18-24
8450,7050,1400,19,male,18-24
18400,12300,6100,34,Female,25-39
9950,8300,1650,18,male,18-24
26600,22900,3700,18,female,18-24
10950,7300,3650,19,male,18-24
53850,20400,33450,21,female,18-24
9850,8350,1500,18,male,18-24
10450,8400,2050,20,male,18-24
47350,15250,32100,18,female,18-24
34800,10850,23950,19,female,18-24
43250,17650,25600,18,female,18-24
16300,11900,4400,25,male,25-39
18250,9600,8650,27,male,25-39
23600,13350,10250,33,Female,25-39
10000,7750,2250,19,male,18-24
124100,36900,87200,23,male,18-24
51350,10950,40400,19,female,18-24
30950,16400,14550,18,female,18-24
40800,18700,22100,19,female,18-24
52500,18800,33700,22,female,18-24
12350,8250,4100,20,male,18-24
11550,8650,2900,42,female,40+
51900,10750,41150,19,female,18-24
97350,37500,59850,21,male,18-24
17250,13550,3700,35,Female,25-39
9800,7900,1900,18,male,18-24
8650,9050,-400,18,male,18-24
20150,11750,8400,37,Female,25-39
36800,19000,17800,18,female,18-24
18750,11900,6850,34,Female,25-39
53450,21550,31900,21,female,18-24
9050,9250,-200,20,male,18-24
133600,41600,92000,22,male,18-24
10800,12950,-2150,27,male,25-39
6000,9850,-3850,18,male,18-24
53900,13250,40650,18,female,18-24
8650,7050,1600,18,male,18-24
6000,7550,-1550,18,male,18-24
10900,6750,4150,19,male,18-24
7500,9350,-1850,18,male,18-24
53150,17900,35250,22,female,18-24
7600,9000,-1400,20,male,18-24
12500,7800,4700,18,male,18-24
48250,12650,35600,19,female,18-24
32250,14800,17450,18,female,18-24
9200,8150,1050,18,male,18-24
23650,12250,11400,29,male,25-39
19500,12500,7000,25,female,25-39
12050,7800,4250,19,male,18-24
5550,9000,-3450,20,male,18-24
54350,14050,40300,23,female,18-24
28300,11900,16400,18,female,18-24
37700,13750,23950,19,female,18-24
9700,7800,1900,20,male,18-24
9300,7100,2200,19,male,18-24
33150,12050,21100,18,female,18-24
9100,6100,3000,20,male,18-24
20450,15150,5300,28,FEMALE,25-39
11650,7850,3800,18,male,18-24
104100,42900,61200,22,male,18-24
47600,20200,27400,18,female,18-24
6000,10900,-4900,19,male,18-24
9350,7750,1600,18,male,18-24
15550,13350,2200,29,male,25-39
52100,20500,31600,18,female,18-24
37200,14800,22400,18,female,18-24
40200,18500,21700,18,female,18-24
22150,13550,8600,25,female,25-39
50050,19750,30300,19,female,18-24
12150,8650,3500,19,male,18-24
45500,9450,36050,19,female,18-24
50350,16600,33750,18,female,18-24
14100,10800,3300,34,male,25-39
25150,14500,10650,33,Female,25-39
18900,14650,4250,36,male,25-39
17400,11700,5700,33,male,25-39
40400,14100,26300,19,female,18-24
9500,7400,2100,18,male,18-24
56400,13650,42750,21,female,18-24
28050,12850,15200,27,male,25-39
47000,15650,31350,18,female,18-24
14200,8300,5900,18,male,18-24
37450,14950,22500,18,female,18-24
13650,9600,4050,18,male,18-24
21400,11500,9900,26,male,25-39
20850,11000,9850,25,female,25-39
11500,8200,3300,20,male,18-24
58400,20950,37450,21,female,18-24
10250,9850,400,18,male,18-24
34200,16200,18000,19,female,18-24
26150,16500,9650,18,female,18-24
31300,13850,17450,19,female,18-24
9700,7800,1900,18,male,18-24
12800,12000,800,49,female,40+
42400,19950,22450,18,female,18-24
10300,7600,2700,20,male,18-24
119350,41550,77800,21,male,18-24
8300,8000,300,20,male,18-24
9800,10200,-400,40,male,40+
120300,40300,80000,22,male,18-24
121850,43000,78850,21,male,18-24
30900,13400,17500,18,female,18-24
37950,5000,32950,19,female,18-24
125150,42200,82950,22,male,18-24
11300,7700,3600,18,male,18-24
43050,13550,29500,18,female,18-24
47800,20350,27450,24,female,18-24
110000,36800,73200,21,male,18-24
20750,8050,12700,32,male,25-39
23350,10000,13350,34,Female,25-39
23900,11800,12100,27,female,25-39
14400,12300,2100,33,male,25-39
14400,10600,3800,31,Female,25-39
20550,14900,5650,29,FEMALE,25-39
9850,8600,1250,19,male,18-24
9050,8850,200,18,male,18-24
10750,8750,2000,19,male,18-24
20450,11950,8500,30,male,25-39
10600,8250,2350,20,male,18-24
8500,9500,-1000,20,male,18-24
48650,9650,39000,18,female,18-24
18800,10900,7900,32,male,25-39
18850,12050,6800,31,male,25-39
18050,9700,8350,30,male,25-39
15750,11000,4750,26,male,25-39
34900,20200,14700,19,female,18-24
56750,22300,34450,22,female,18-24
12900,8450,4450,20,male,18-24
10300,8150,2150,20,male,18-24
33600,14450,19150,18,female,18-24
11700,8800,2900,19,male,18-24
19500,10450,9050,35,Female,25-39
47400,21450,25950,21,female,18-24
18350,12150,6200,32,male,25-39
12700,8400,4300,18,male,18-24
30400,13150,17250,18,female,18-24
45850,15100,30750,18,female,18-24
36700,15500,21200,18,female,18-24
8550,7250,1300,19,male,18-24
53550,24100,29450,24,female,18-24
35850,15550,20300,19,female,18-24
12200,8550,3650,19,male,18-24
15500,9850,5650,33,Female,25-39
131450,42150,89300,21,male,18-24
51250,12250,39000,19,female,18-24
20700,15100,5600,32,male,25-39
11450,8200,3250,18,male,18-24
51700,16500,35200,22,female,18-24
46550,15800,30750,18,female,18-24
18300,12150,6150,27,female,25-39
26200,10100,16100,34,male,25-39
9350,8200,1150,18,male,18-24
9700,7300,2400,18,male,18-24
18150,11800,6350,27,male,25-39
108150,42850,65300,21,male,18-24
7400,9350,-1950,20,male,18-24
6950,8750,-1800,20,male,18-24
9600,9700,-100,20,male,18-24
36550,18100,18450,18,female,18-24
10100,8500,1600,18,male,18-24
11900,6850,5050,20,male,18-24
24450,12350,12100,18,female,18-24
51500,14650,36850,24,female,18-24
36900,14500,22400,18,female,18-24
12250,7000,5250,19,male,18-24
24000,9550,14450,26,male,25-39
45000,17000,28000,19,female,18-24
38050,16500,21550,19,female,18-24
9900,9150,750,18,male,18-24
45550,17900,27650,18,female,18-24
22750,13400,9350,35,male,25-39
8650,9000,-350,18,male,18-24
11100,8300,2800,18,male,18-24
11050,11450,-400,40,female,40+
25950,8700,17250,27,male,25-39
19400,11350,8050,31,male,25-39
12500,8350,4150,20,male,18-24
8100,9200,-1100,18,male,18-24
12500,7600,4900,20,male,18-24
42650,11300,31350,18,female,18-24
31000,12100,18900,18,female,18-24
14550,10200,4350,26,female,25-39
10400,6650,3750,19,male,18-24
9200,7000,2200,18,male,18-24
9400,8550,850,18,male,18-24
22600,11200,11400,32,Female,25-39
96700,45100,51600,21,male,18-24
18200,14200,4000,25,male,25-39
46250,13350,32900,18,female,18-24
8150,8450,-300,18,male,18-24
11700,4800,6900,20,male,18-24
9450,9100,350,20,male,18-24
40300,19000,21300,22,female,18-24
56050,20800,35250,22,female,18-24
126250,40650,85600,21,male,18-24
44850,17450,27400,24,female,18-24
14550,11950,2600,34,male,25-39
10550,6850,3700,18,male,18-24
52800,21700,31100,18,female,18-24
25400,11350,14050,29,FEMALE,25-39
46000,19650,26350,24,female,18-24
53150,15550,37600,19,female,18-24
15800,11050,4750,27,female,25-39
7300,9400,-2100,18,male,18-24
7000,8350,-1350,19,male,18-24
38800,12950,25850,19,female,18-24
5100,7700,-2600,19,male,18-24
31200,16000,15200,19,female,18-24
9400,7950,1450,20,male,18-24
35700,15200,20500,19,female,18-24
48400,13200,35200,18,female,18-24
10550,6500,4050,20,male,18-24
20300,12750,7550,30,male,25-39
46400,9700,36700,19,female,18-24
47150,11900,35250,18,female,18-24
9550,7700,1850,18,male,18-24
36250,15950,20300,18,female,18-24
22750,12200,10550,34,Female,25-39
63350,27600,35750,21,female,18-24
32500,14800,17700,18,female,18-24
7800,9650,-1850,18,male,18-24
12250,8600,3650,19,male,18-24
119000,42800,76200,21,male,18-24
41150,16800,24350,19,female,18-24
9250,8800,450,18,male,18-24
11900,8800,3100,18,male,18-24
53650,28200,25450,22,female,18-24
10000,8800,1200,18,male,18-24
20150,9700,10450,33,male,25-39
49700,16300,33400,18,female,18-24
113250,37700,75550,21,male,18-24
10850,14250,-3400,35,Female,25-39
38600,25700,12900,23,female,18-24
119600,41850,77750,21,male,18-24
15100,9800,5300,32,Female,25-39
24200,8650,15550,28,male,25-39
8050,7550,500,19,male,18-24
11200,9200,2000,19,male,18-24
30900,16400,14500,19,female,18-24
19150,10700,8450,28,male,25-39
9750,8650,1100,20,male,18-24
20400,11450,8950,37,Female,25-39
51950,15550,36400,18,female,18-24
36550,11550,25000,19,female,18-24
20100,12250,7850,38,Female,25-39
10350,7650,2700,18,male,18-24
9300,7200,2100,18,male,18-24
12150,8450,3700,19,male,18-24
11500,7750,3750,18,male,18-24
16150,11900,4250,35,Female,25-39
43950,14250,29700,24,female,18-24
39400,16250,23150,18,female,18-24
55250,22250,33000,21,female,18-24
5600,7050,-1450,19,male,18-24
10600,6550,4050,19,male,18-24
11800,6800,5000,18,male,18-24
11600,10100,1500,18,male,18-24
47500,18400,29100,22,female,18-24
7700,7750,-50,20,male,18-24
24500,12750,11750,25,female,25-39
58150,18750,39400,22,female,18-24
17800,15200,2600,31,male,25-39
12400,6450,5950,20,male,18-24
8950,8600,350,18,male,18-24
37300,16200,21100,18,female,18-24
9800,8600,1200,19,male,18-24
18500,13600,4900,33,male,25-39
19150,10950,8200,37,Female,25-39
9900,10350,-450,18,male,18-24
8750,8350,400,19,male,18-24
16050,11550,4500,26,male,25-39
9500,6650,2850,18,male,18-24
12700,7450,5250,20,male,18-24
35600,14350,21250,19,female,18-24
40300,11400,28900,18,female,18-24
9050,9350,-300,20,male,18-24
29750,17600,12150,18,female,18-24
9600,7500,2100,19,male,18-24
11400,6500,4900,19,male,18-24
29200,12550,16650,31,Female,25-39
21450,10850,10600,28,FEMALE,25-39
8800,13000,-4200,28,male,25-39
9100,9500,-400,18,male,18-24
10650,11900,-1250,45,female,40+
24450,8350,16100,34,male,25-39
8050,8700,-650,18,male,18-24
7000,8000,-1000,20,male,18-24
31600,20050,11550,18,female,18-24
12950,15100,-2150,33,Female,25-39
38150,13150,25000,19,female,18-24
14500,7400,7100,18,male,18-24
28300,12250,16050,19,female,18-24
53250,12250,41000,19,female,18-24
50150,18350,31800,19,female,18-24
11150,7550,3600,18,male,18-24
8200,7500,700,18,male,18-24
16450,9850,6600,31,male,25-39
38000,13050,24950,19,female,18-24
50250,22150,28100,22,female,18-24
13800,7350,6450,18,male,18-24
21700,11250,10450,31,male,25-39
16450,13250,3200,35,male,25-39
15550,11900,3650,25,male,25-39
22750,12250,10500,35,Female,25-39
18650,10400,8250,38,Female,25-39
46000,20850,25150,19,female,18-24
123800,54350,69450,24,male,18-24
10550,8500,2050,18,male,18-24
16900,15450,1450,38,male,25-39
20350,12400,7950,30,FEMALE,25-39
15050,10700,4350,25,female,25-39
9200,5650,3550,20,male,18-24
32850,12400,20450,19,female,18-24
29050,14050,15000,18,female,18-24
115400,41950,73450,24,male,18-24
23100,9300,13800,28,male,25-39
21000,9850,11150,26,male,25-39
12700,6450,6250,19,male,18-24
7800,9250,-1450,18,male,18-24
48000,14400,33600,19,female,18-24
55400,18850,36550,22,female,18-24
15000,12050,2950,35,Female,25-39
19650,12650,7000,31,male,25-39
60150,18400,41750,19,female,18-24
10800,9950,850,18,male,18-24
8600,7850,750,19,male,18-24
108650,36150,72500,23,male,18-24
29050,15050,14000,19,female,18-24
6000,8000,-2000,18,male,18-24
37050,16700,20350,22,female,18-24
11250,7850,3400,20,male,18-24
49700,14300,35400,18,female,18-24
11250,8750,2500,18,male,18-24
38250,15600,22650,18,female,18-24
46350,12600,33750,19,female,18-24
57550,19400,38150,24,female,18-24
19450,12650,6800,36,male,25-39
18850,13300,5550,29,male,25-39
12100,9400,2700,19,male,18-24
13450,7950,5500,19,male,18-24
13650,7500,6150,20,male,18-24
11250,8750,2500,18,male,18-24
8450,6100,2350,19,male,18-24
13800,8100,5700,19,male,18-24
11250,8050,3200,19,male,18-24
7950,7600,350,18,male,18-24
19250,12950,6300,34,male,25-39
13500,8100,5400,18,male,18-24
13150,7500,5650,18,male,18-24
8950,8800,150,20,male,18-24
8900,7250,1650,18,male,18-24
36250,9700,26550,19,female,18-24
12000,10200,1800,40,male,40+
14700,7800,6900,18,male,18-24
9500,8100,1400,19,male,18-24
9700,8450,1250,18,male,18-24
27600,18200,9400,19,female,18-24
12500,7750,4750,19,male,18-24
29050,12300,16750,18,female,18-24
23650,10000,13650,28,male,25-39
10800,6850,3950,19,male,18-24
17900,11750,6150,26,female,25-39
24550,14350,10200,31,Female,25-39
19500,9150,10350,32,Female,25-39
12000,6800,5200,19,male,18-24
20200,11650,8550,39,male,25-39
7250,7750,-500,18,male,18-24
23450,11700,11750,30,male,25-39
9650,7250,2400,20,male,18-24
35450,19900,15550,19,female,18-24
10450,6550,3900,19,male,18-24
4700,7150,-2450,18,male,18-24
34900,13300,21600,18,female,18-24
12250,8250,4000,19,male,18-24
128550,42100,86450,21,male,18-24
10850,7550,3300,19,male,18-24
9500,8850,650,19,male,18-24
31500,17850,13650,19,female,18-24
30800,14950,15850,18,female,18-24
11900,7200,4700,18,male,18-24
7700,8300,-600,18,male,18-24
55750,25300,30450,22,female,18-24
50900,11300,39600,18,female,18-24
7500,7850,-350,20,male,18-24
53250,22750,30500,24,female,18-24
72100,13650,58450,23,female,18-24
8800,5850,2950,18,male,18-24
11900,7350,4550,20,male,18-24
38200,14350,23850,18,female,18-24
43700,14450,29250,19,female,18-24
28800,13400,15400,18,female,18-24
19100,11950,7150,30,FEMALE,25-39
11100,7050,4050,18,male,18-24
17600,12400,5200,30,male,25-39
43800,11850,31950,19,female,18-24
12150,8150,4000,20,male,18-24
42850,19350,23500,24,female,18-24
22750,10300,12450,28,female,25-39
23200,12150,11050,32,Female,25-39
22650,11250,11400,32,Female,25-39
42700,13100,29600,18,female,18-24
9900,6700,3200,20,male,18-24
8950,8850,100,20,male,18-24
42550,16500,26050,19,female,18-24
17150,11450,5700,30,FEMALE,25-39
52450,22500,29950,19,female,18-24
116100,38050,78050,21,male,18-24
22850,10750,12100,39,Female,25-39
10200,6800,3400,19,male,18-24
7350,8650,-1300,18,male,18-24
11450,8150,3300,19,male,18-24
4250,9150,-4900,18,male,18-24
11650,7950,3700,19,male,18-24
102600,42850,59750,21,male,18-24
15750,14500,1250,31,male,25-39
46500,14800,31700,19,female,18-24
32800,15450,17350,19,female,18-24
46400,16550,29850,18,female,18-24
9850,5950,3900,19,male,18-24
10200,8300,1900,18,male,18-24
45100,11400,33700,22,female,18-24
41500,16000,25500,19,female,18-24
15900,12800,3100,28,FEMALE,25-39
29550,20550,9000,19,female,18-24
26700,18150,8550,19,female,18-24
36650,14150,22500,18,female,18-24
22050,15900,6150,27,male,25-39
6700,8300,-1600,19,male,18-24
57550,8250,49300,19,female,18-24
26850,8850,18000,33,Female,25-39
26050,12550,13500,34,Female,25-39
9750,9300,450,19,male,18-24
129700,32750,96950,24,male,18-24
53850,14150,39700,18,female,18-24
10200,9150,1050,18,male,18-24
5600,7700,-2100,18,male,18-24
10500,7200,3300,18,male,18-24
19350,13700,5650,26,female,25-39
9150,8650,500,18,male,18-24
17150,11000,6150,33,Female,25-39
40700,14450,26250,19,female,18-24
18300,12600,5700,25,female,25-39
41950,18200,23750,21,female,18-24
16950,11850,5100,25,male,25-39
8900,7000,1900,18,male,18-24
19650,12500,7150,29,FEMALE,25-39
43950,10550,33400,18,female,18-24
13500,7750,5750,20,male,18-24
24550,11650,12900,36,Female,25-39
35350,10500,24850,18,female,18-24
32150,12700,19450,18,female,18-24
35000,15350,19650,18,female,18-24
42700,8650,34050,19,female,18-24
26250,10450,15800,33,male,25-39
46250,19400,26850,24,female,18-24
45400,18000,27400,19,female,18-24
9700,8300,1400,19,male,18-24
21250,11700,9550,18,female,18-24
12900,7350,5550,20,male,18-24
9200,9250,-50,18,male,18-24
40850,19100,21750,18,female,18-24
17400,8000,9400,19,male,18-24
17350,15350,2000,26,female,25-39
16000,15350,650,28,FEMALE,25-39
8550,6900,1650,20,male,18-24
33500,15850,17650,18,female,18-24
44500,12500,32000,18,female,18-24
42300,13950,28350,18,female,18-24
9950,6500,3450,19,male,18-24
9300,9250,50,18,male,18-24
8550,8350,200,20,male,18-24
15600,14600,1000,30,FEMALE,25-39
23950,11800,12150,26,female,25-39
20250,16700,3550,25,female,25-39
42300,29150,13150,22,female,18-24
40950,14550,26400,18,female,18-24
11650,7250,4400,20,male,18-24
17250,12850,4400,34,male,25-39
21450,13650,7800,26,male,25-39
19950,9400,10550,27,male,25-39
20200,13950,6250,33,Female,25-39
39750,11950,27800,18,female,18-24
51750,14900,36850,18,female,18-24
10350,6200,4150,18,male,18-24
23100,11800,11300,33,Female,25-39
13150,9000,4150,20,male,18-24
56250,20150,36100,21,female,18-24
34000,15650,18350,18,female,18-24
13450,12900,550,28,male,25-39
9550,9750,-200,20,male,18-24
25700,12850,12850,18,female,18-24
11600,7650,3950,18,male,18-24
34800,16050,18750,18,female,18-24
58900,19100,39800,21,female,18-24
122550,41600,80950,21,male,18-24
15250,10700,4550,39,Female,25-39
23100,14850,8250,29,male,25-39
126050,42350,83700,21,male,18-24
12750,8850,3900,31,male,25-39
39650,17550,22100,19,female,18-24
19450,13550,5900,27,female,25-39
54850,18400,36450,21,female,18-24
45700,23900,21800,21,female,18-24
59600,13400,46200,19,female,18-24
32600,15150,17450,18,female,18-24
12050,9000,3050,18,male,18-24
20400,11050,9350,31,Female,25-39
38200,3500,34700,19,female,18-24
119450,41450,78000,21,male,18-24
10500,8100,2400,20,male,18-24
27150,12400,14750,35,male,25-39
47050,13050,34000,19,female,18-24
7900,8200,-300,18,male,18-24
14400,13700,700,36,male,25-39
46250,20000,26250,19,female,18-24
40550,14300,26250,18,female,18-24
11000,7200,3800,18,male,18-24
9200,8950,250,18,male,18-24
13000,9250,3750,18,male,18-24
20950,12300,8650,31,male,25-39
11150,8550,2600,19,male,18-24
47600,14950,32650,19,female,18-24
16350,11050,5300,31,Female,25-39
9200,7600,1600,18,male,18-24
7600,8100,-500,18,male,18-24
34700,12450,22250,19,female,18-24
35900,20450,15450,19,female,18-24
46850,16600,30250,18,female,18-24
8950,8650,300,20,male,18-24
7450,8850,-1400,20,male,18-24
45750,16250,29500,19,female,18-24
107200,35000,72200,21,male,18-24
24800,18050,6750,18,female,18-24
14050,7900,6150,18,male,18-24
49850,11600,38250,18,female,18-24
36000,13800,22200,18,female,18-24
41800,18300,23500,18,female,18-24
14400,8800,5600,18,male,18-24
20900,10500,10400,33,male,25-39
11100,6950,4150,20,male,18-24
26350,7000,19350,25,female,25-39
7650,6950,700,18,male,18-24
15600,13000,2600,28,FEMALE,25-39
11650,7850,3800,20,male,18-24
25100,11350,13750,32,Female,25-39
51750,12850,38900,18,female,18-24
116950,41750,75200,21,male,18-24
20450,12100,8350,25,male,25-39
8500,8400,100,19,male,18-24
11200,8700,2500,20,male,18-24
44950,14200,30750,19,female,18-24
11450,6150,5300,18,male,18-24
40700,17350,23350,18,female,18-24
12300,6650,5650,19,male,18-24
9700,8150,1550,18,male,18-24
12050,11100,950,44,female,40+
34350,15700,18650,19,female,18-24
25700,13850,11850,18,female,18-24
44900,14300,30600,19,female,18-24
14900,11450,3450,34,male,25-39
10550,6900,3650,20,male,18-24
127300,44700,82600,21,male,18-24
10950,7300,3650,20,male,18-24
24050,9850,14200,34,male,25-39
125300,42950,82350,21,male,18-24
5700,6800,-1100,19,male,18-24
8550,7350,1200,18,male,18-24
52850,24150,28700,21,female,18-24
8500,8400,100,20,male,18-24
16750,10250,6500,32,Female,25-39
11400,9850,1550,19,male,18-24
38450,17450,21000,18,female,18-24
25500,11600,13900,27,female,25-39
18800,14050,4750,31,Female,25-39
11800,6700,5100,18,male,18-24
50350,19650,30700,18,female,18-24
12250,6150,6100,20,male,18-24
52400,20400,32000,22,female,18-24
10400,8100,2300,18,male,18-24
15200,7900,7300,18,male,18-24
30150,17250,12900,19,female,18-24
13250,14950,-1700,31,Female,25-39
32250,15050,17200,18,female,18-24
7150,7300,-150,20,male,18-24
11050,9050,2000,19,male,18-24
23200,13150,10050,34,Female,25-39
9350,8450,900,20,male,18-24
31450,13500,17950,19,female,18-24
19450,12200,7250,29,FEMALE,25-39
44000,12750,31250,19,female,18-24
17050,12400,4650,29,FEMALE,25-39
127950,43600,84350,21,male,18-24
22900,11100,11800,31,male,25-39
22750,14450,8300,30,FEMALE,25-39
44450,23650,20800,22,female,18-24
14700,7650,7050,18,male,18-24
20750,10200,10550,35,Female,25-39
11400,7700,3700,19,male,18-24
37550,14700,22850,18,female,18-24
44750,24100,20650,22,female,18-24
19700,10000,9700,35,Female,25-39
35800,8750,27050,18,female,18-24
10350,8150,2200,18,male,18-24
9950,8350,1600,20,male,18-24
9000,7500,1500,20,male,18-24
7950,8550,-600,19,male,18-24
24250,12950,11300,31,Female,25-39
9400,8600,800,19,male,18-24
21900,10900,11000,34,Female,25-39
46550,15150,31400,19,female,18-24
56350,17750,38600,24,female,18-24
18000,12550,5450,38,Female,25-39
43850,13250,30600,18,female,18-24
34000,14800,19200,18,female,18-24
10550,10300,250,45,female,40+
5600,10050,-4450,19,male,18-24
15950,12650,3300,35,Female,25-39
16350,13050,3300,34,male,25-39
42550,15300,27250,18,female,18-24
43600,16550,27050,21,female,18-24
8750,8000,750,20,male,18-24
18300,13150,5150,38,male,25-39
35650,17750,17900,18,female,18-24
12650,7900,4750,18,male,18-24
20600,12100,8500,33,Female,25-39
15300,13800,1500,30,FEMALE,25-39
10150,7400,2750,18,male,18-24
10800,7400,3400,18,male,18-24
43650,12800,30850,18,female,18-24
15300,15200,100,28,female,25-39
19650,12900,6750,26,male,25-39
44900,16200,28700,21,female,18-24
56200,15850,40350,22,female,18-24
48150,10950,37200,18,female,18-24
6700,6100,600,18,male,18-24
11100,7350,3750,18,male,18-24
19200,10350,8850,27,female,25-39
40150,9750,30400,19,female,18-24
12850,8250,4600,18,male,18-24
6900,7900,-1000,19,male,18-24
45050,25400,19650,21,female,18-24
27800,13700,14100,33,male,25-39
47750,9300,38450,19,female,18-24
10950,9000,1950,19,male,18-24
13550,7400,6150,19,male,18-24
43300,19150,24150,21,female,18-24
49300,20000,29300,18,female,18-24
6300,6700,-400,20,male,18-24
23250,9450,13800,27,male,25-39
37200,17950,19250,19,female,18-24
41100,9900,31200,18,female,18-24
10150,7850,2300,20,male,18-24
8550,7950,600,19,male,18-24
18650,11250,7400,25,female,25-39
10150,7850,2300,19,male,18-24
43850,15000,28850,18,female,18-24
137500,33750,103750,21,male,18-24
46700,12800,33900,18,female,18-24
112250,40100,72150,21,male,18-24
10450,6700,3750,20,male,18-24
14900,13200,1700,29,FEMALE,25-39
10250,7700,2550,18,male,18-24
6300,8400,-2100,18,male,18-24
47550,16850,30700,18,female,18-24
7950,8500,-550,18,male,18-24
66000,22150,43850,22,female,18-24
33600,12900,20700,18,female,18-24
21050,14150,6900,28,male,25-39
132350,37550,94800,21,male,18-24
10300,8900,1400,19,male,18-24
6200,6900,-700,19,male,18-24
41300,20200,21100,19,female,18-24
33700,13200,20500,19,female,18-24
52600,20150,32450,21,female,18-24
11200,7800,3400,20,male,18-24
10550,7250,3300,18,male,18-24
17550,13200,4350,33,male,25-39
46750,12650,34100,18,female,18-24
6400,8650,-2250,19,male,18-24
20750,11150,9600,37,male,25-39
21300,9250,12050,37,Female,25-39
115100,42850,72250,23,male,18-24
44250,15950,28300,18,female,18-24
11800,7650,4150,18,male,18-24
6350,8100,-1750,19,male,18-24
139600,38300,101300,23,male,18-24
19200,12350,6850,28,male,25-39
11950,11250,700,43,female,40+
20650,11300,9350,27,male,25-39
20100,9850,10250,30,male,25-39
43050,14800,28250,18,female,18-24
10250,8050,2200,19,male,18-24
20800,13400,7400,38,Female,25-39
20550,12500,8050,33,Female,25-39
26600,16100,10500,18,female,18-24
28550,16150,12400,19,female,18-24
53000,21750,31250,21,female,18-24
49500,20550,28950,24,female,18-24
21850,7350,14500,26,female,25-39
12750,11450,1300,36,male,25-39
45150,13650,31500,22,female,18-24
9800,7800,2000,18,male,18-24
118900,45000,73900,21,male,18-24
13700,10500,3200,39,Female,25-39
7450,7400,50,19,male,18-24
116700,41050,75650,21,male,18-24
108050,39150,68900,21,male,18-24
9450,7950,1500,19,male,18-24
11650,7200,4450,26,male,25-39
56050,15250,40800,24,female,18-24
19600,10200,9400,34,Female,25-39
15950,12200,3750,26,female,25-39
9800,7800,2000,18,male,18-24
15450,8900,6550,27,female,25-39
113750,42500,71250,23,male,18-24
49250,28000,21250,22,female,18-24
15950,14700,1250,30,FEMALE,25-39
107350,39800,67550,21,male,18-24
11150,9100,2050,19,male,18-24
22250,14850,7400,25,female,25-39
23200,14550,8650,26,male,25-39
11250,7200,4050,19,male,18-24
12400,9550,2850,19,male,18-24
16000,7650,8350,29,FEMALE,25-39
11100,11150,-50,33,male,25-39
54700,17950,36750,23,female,18-24
20450,10650,9800,30,FEMALE,25-39
43650,21100,22550,19,female,18-24
10150,8250,1900,19,male,18-24
34600,14350,20250,19,female,18-24
10700,8400,2300,18,male,18-24
10100,10850,-750,44,female,40+
8400,6900,1500,18,male,18-24
9650,6950,2700,18,male,18-24
8800,9400,-600,20,male,18-24
43050,17800,25250,18,female,18-24
12050,11850,200,31,male,25-39
9750,9850,-100,19,male,18-24
10150,15550,-5400,28,male,25-39
22000,11800,10200,29,male,25-39
8850,8100,750,19,male,18-24
53000,18500,34500,21,female,18-24
11850,8100,3750,20,male,18-24
41900,19250,22650,22,female,18-24
9950,8800,1150,18,male,18-24
9950,8800,1150,18,male,18-24
46400,10250,36150,18,female,18-24
40550,9950,30600,19,female,18-24
8000,7400,600,18,male,18-24
12700,8550,4150,20,male,18-24
14400,12650,1750,33,Female,25-39
10500,6850,3650,20,male,18-24
12350,7350,5000,19,male,18-24
55950,10200,45750,23,female,18-24
49200,15200,34000,18,female,18-24
14850,12950,1900,35,Female,25-39
18300,9600,8700,26,male,25-39
21250,11750,9500,25,female,25-39
12950,8900,4050,18,male,18-24
31600,16650,14950,19,female,18-24
110700,42100,68600,23,male,18-24
27750,16300,11450,18,female,18-24
9600,8600,1000,19,male,18-24
28850,19900,8950,18,female,18-24
23550,10700,12850,32,Female,25-39
47450,13900,33550,19,female,18-24
50450,17650,32800,21,female,18-24
11150,7750,3400,19,male,18-24
7400,6400,1000,18,male,18-24
47150,14150,33000,18,female,18-24
119750,42900,76850,22,male,18-24
10350,6550,3800,20,male,18-24
15350,14050,1300,27,male,25-39
34400,11000,23400,19,female,18-24
25750,21550,4200,18,female,18-24
10050,7950,2100,19,male,18-24
9350,7900,1450,19,male,18-24
64600,18500,46100,21,female,18-24
33650,23900,9750,21,female,18-24
122550,45750,76800,21,male,18-24
23450,12400,11050,29,male,25-39
44000,11550,32450,24,female,18-24
17650,9100,8550,27,male,25-39
10750,9200,1550,20,male,18-24
129200,36600,92600,23,male,18-24
25250,11650,13600,33,male,25-39
13050,8100,4950,19,male,18-24
22000,11550,10450,34,male,25-39
10500,10000,500,19,male,18-24
44800,11700,33100,24,female,18-24
8800,7700,1100,18,male,18-24
40550,11350,29200,18,female,18-24
35050,20100,14950,18,female,18-24
36500,16450,20050,19,female,18-24
22550,14350,8200,32,Female,25-39
8550,8800,-250,20,male,18-24
8350,9150,-800,18,male,18-24
14450,13200,1250,30,male,25-39
8300,7950,350,18,male,18-24
33450,17250,16200,18,female,18-24
13850,5700,8150,19,male,18-24
15250,12900,2350,39,Female,25-39
16550,13350,3200,18,female,18-24
10100,8050,2050,19,male,18-24
16200,14100,2100,36,male,25-39
41250,12950,28300,18,female,18-24
24250,6800,17450,39,Female,25-39
29950,11000,18950,19,female,18-24
17900,9100,8800,39,male,25-39
60900,29500,31400,21,female,18-24
43850,25250,18600,22,female,18-24
126700,32200,94500,24,male,18-24
16050,7200,8850,18,male,18-24
18950,13300,5650,26,male,25-39
55850,24250,31600,21,female,18-24
9650,7450,2200,19,male,18-24
36600,19850,16750,18,female,18-24
131150,42050,89100,21,male,18-24
43000,13200,29800,18,female,18-24
39000,21650,17350,22,female,18-24
7450,6450,1000,18,male,18-24
21550,12600,8950,31,Female,25-39
9650,8950,700,19,male,18-24
10650,9500,1150,19,male,18-24
35600,14900,20700,18,female,18-24
10200,6950,3250,18,male,18-24
8450,8350,100,20,male,18-24
8650,9600,-950,19,male,18-24
52250,17150,35100,18,female,18-24
15950,12900,3050,28,FEMALE,25-39
13450,7650,5800,20,male,18-24
8450,9600,-1150,18,male,18-24
39450,16850,22600,18,female,18-24
10900,8650,2250,19,male,18-24
36850,23850,13000,21,female,18-24
20100,10150,9950,36,Female,25-39
9300,8700,600,20,male,18-24
13600,12150,1450,28,FEMALE,25-39
8150,7600,550,18,male,18-24
7000,8050,-1050,19,male,18-24
34050,11850,22200,19,female,18-24
10500,10650,-150,28,female,25-39
45300,17300,28000,18,female,18-24
102800,45650,57150,21,male,18-24
36800,14100,22700,19,female,18-24
110350,42200,68150,23,male,18-24
7350,8400,-1050,19,male,18-24
25050,11250,13800,27,male,25-39
50350,18350,32000,19,female,18-24
8300,8600,-300,19,male,18-24
9350,6700,2650,18,male,18-24
118150,33250,84900,21,male,18-24
66600,22850,43750,21,female,18-24
23350,11250,12100,26,female,25-39
6050,6700,-650,18,male,18-24
33900,11350,22550,18,female,18-24
12100,14850,-2750,34,Female,25-39
8900,7650,1250,19,male,18-24
10100,8400,1700,18,male,18-24
36600,11500,25100,18,female,18-24
14550,10000,4550,18,male,18-24
47450,21700,25750,24,female,18-24
34750,16400,18350,18,female,18-24
24550,13800,10750,30,male,25-39
115450,34450,81000,21,male,18-24
43050,14900,28150,18,female,18-24
17600,13500,4100,36,male,25-39
9850,7450,2400,20,male,18-24
10550,8700,1850,18,male,18-24
5400,7150,-1750,18,male,18-24
40050,14750,25300,18,female,18-24
9300,6850,2450,19,male,18-24
23050,17800,5250,30,male,25-39
10500,8500,2000,41,male,40+
12350,6100,6250,19,male,18-24
34850,11650,23200,19,female,18-24
11800,7650,4150,19,male,18-24
48800,14750,34050,19,female,18-24
45000,18150,26850,21,female,18-24
36850,20600,16250,22,female,18-24
9800,8200,1600,19,male,18-24
116450,34750,81700,24,male,18-24
7900,8750,-850,20,male,18-24
6750,8250,-1500,19,male,18-24
13800,8550,5250,18,male,18-24
8200,7650,550,19,male,18-24
30400,17250,13150,18,female,18-24
21850,12350,9500,39,Female,25-39
34350,18550,15800,19,female,18-24
20350,15350,5000,34,male,25-39
15350,13250,2100,32,male,25-39
12150,9900,2250,45,female,40+
50400,16400,34000,20,female,18-24
6950,6800,150,18,male,18-24
9300,6200,3100,18,male,18-24
116650,40500,76150,21,male,18-24
54400,13600,40800,18,female,18-24
10600,10200,400,35,male,25-39
11100,8550,2550,19,male,18-24
17000,13400,3600,32,Female,25-39
38900,17150,21750,19,female,18-24
116550,38550,78000,22,male,18-24
12200,7150,5050,18,male,18-24
7750,7150,600,18,male,18-24
22450,12250,10200,33,Female,25-39
14100,7300,6800,20,male,18-24
50500,16850,33650,18,female,18-24
18850,10950,7900,31,Female,25-39
10200,8200,2000,18,male,18-24
40150,20350,19800,24,female,18-24
34300,17450,16850,19,female,18-24
15350,7400,7950,37,Female,25-39
10850,6400,4450,18,male,18-24
6400,9150,-2750,18,male,18-24
53100,22750,30350,21,female,18-24
9150,7250,1900,19,male,18-24
7000,7200,-200,20,male,18-24
56800,27700,29100,23,female,18-24
16150,10450,5700,27,male,25-39
122900,45150,77750,21,male,18-24
9850,8550,1300,19,male,18-24
11650,7350,4300,19,male,18-24
9550,10950,-1400,29,FEMALE,25-39
53700,18550,35150,21,female,18-24
48300,15750,32550,18,female,18-24
26150,12700,13450,23,female,18-24
10200,8000,2200,19,male,18-24
120800,40400,80400,21,male,18-24
7750,6750,1000,18,male,18-24
6000,7350,-1350,18,male,18-24
33900,13500,20400,19,female,18-24
22500,12650,9850,26,male,25-39
52150,17150,35000,18,female,18-24
35600,16300,19300,19,female,18-24
14000,8700,5300,19,male,18-24
39550,12850,26700,18,female,18-24
11700,8900,2800,18,male,18-24
19900,14050,5850,25,female,25-39
15200,11000,4200,27,female,25-39
31750,16400,15350,18,female,18-24
13600,9650,3950,20,male,18-24
33800,15900,17900,18,female,18-24
9350,6800,2550,19,male,18-24
24600,12650,11950,30,Female,25-39
9000,8200,800,20,male,18-24
7800,9450,-1650,19,male,18-24
25400,12800,12600,30,FEMALE,25-39
6650,7350,-700,20,male,18-24
16250,7350,8900,18,male,18-24
48300,24900,23400,23,female,18-24
18300,9600,8700,32,male,25-39
17550,13700,3850,29,FEMALE,25-39
15850,10050,5800,34,Female,25-39
17250,10300,6950,34,Female,25-39
25650,11000,14650,25,female,25-39
43400,16450,26950,22,female,18-24
43650,19500,24150,18,female,18-24
11450,10400,1050,18,male,18-24
48250,21350,26900,18,female,18-24
41000,12400,28600,19,female,18-24
55500,17100,38400,24,female,18-24
38450,15950,22500,19,female,18-24
9700,9000,700,18,male,18-24
15100,12000,3100,37,Female,25-39
7300,8350,-1050,18,male,18-24
118100,40500,77600,21,male,18-24
24200,13400,10800,27,female,25-39
109950,35400,74550,21,male,18-24
45200,17000,28200,18,female,18-24
25500,12450,13050,31,Female,25-39
54150,16800,37350,23,female,18-24
21550,10750,10800,33,Female,25-39
21950,15000,6950,25,female,25-39
11450,7600,3850,19,male,18-24
8650,7750,900,18,male,18-24
18550,10150,8400,33,male,25-39
7400,7900,-500,19,male,18-24
9250,6700,2550,19,male,18-24
9050,9500,-450,19,male,18-24
7750,7850,-100,19,male,18-24
31450,19750,11700,18,female,18-24
10900,11250,-350,40,female,40+
42300,10250,32050,18,female,18-24
12650,11750,900,31,Female,25-39
10100,6700,3400,18,male,18-24
19700,14900,4800,30,male,25-39
36450,16550,19900,19,female,18-24
8300,8000,300,18,male,18-24
11600,10250,1350,18,male,18-24
48200,15050,33150,19,female,18-24
6250,12000,-5750,30,FEMALE,25-39
122950,41150,81800,21,male,18-24
51650,15350,36300,18,female,18-24
110250,38850,71400,24,male,18-24
35100,16900,18200,19,female,18-24
32650,18050,14600,18,female,18-24
50200,10200,40000,18,female,18-24
52850,21650,31200,21,female,18-24
9550,9600,-50,20,male,18-24
11400,7450,3950,19,male,18-24
12450,12350,100,45,female,40+
9750,8900,850,39,male,25-39
42750,8700,34050,18,female,18-24
40950,16850,24100,19,female,18-24
11400,8000,3400,19,male,18-24
44250,22800,21450,21,female,18-24
47700,19900,27800,21,female,18-24
29500,14000,15500,19,female,18-24
23300,11400,11900,27,female,25-39
11950,13500,-1550,29,FEMALE,25-39
7900,6700,1200,18,male,18-24
19000,11800,7200,33,male,25-39
19700,9100,10600,31,Female,25-39
12850,7550,5300,18,male,18-24
24400,9750,14650,31,male,25-39
9250,7500,1750,18,male,18-24
10100,8200,1900,18,male,18-24
23600,10500,13100,26,female,25-39
19750,11050,8700,33,male,25-39
63000,13050,49950,21,female,18-24
11200,6850,4350,20,male,18-24
59000,10650,48350,22,female,18-24
51750,17600,34150,23,female,18-24
16100,10750,5350,39,male,25-39
63250,19050,44200,21,female,18-24
11050,10050,1000,18,male,18-24
123750,42600,81150,21,male,18-24
10400,8050,2350,19,male,18-24
10100,8800,1300,18,male,18-24
49550,11100,38450,19,female,18-24
16800,7550,9250,38,Female,25-39
24650,9850,14800,33,Female,25-39
10050,7850,2200,19,male,18-24
12350,10000,2350,19,male,18-24
36950,16100,20850,18,female,18-24
53850,23000,30850,21,female,18-24
22550,13250,9300,35,Female,25-39
57750,16650,41100,19,female,18-24
9300,7750,1550,20,male,18-24
21000,10950,10050,29,male,25-39
22000,10850,11150,28,male,25-39
39200,14350,24850,19,female,18-24
37800,20500,17300,18,female,18-24
9050,7200,1850,19,male,18-24
11150,13900,-2750,30,FEMALE,25-39
9650,7400,2250,19,male,18-24
7800,7500,300,18,male,18-24
11500,10500,1000,18,male,18-24
23050,8250,14800,32,male,25-39
53150,28900,24250,23,female,18-24
10700,7600,3100,19,male,18-24
132900,38600,94300,21,male,18-24
39850,13400,26450,19,female,18-24
115100,35900,79200,22,male,18-24
43950,11700,32250,21,female,18-24
115650,45700,69950,21,male,18-24
23250,10750,12500,31,Female,25-39
18050,13700,4350,25,male,25-39
28350,16400,11950,35,Female,25-39
110400,37850,72550,21,male,18-24
19700,10700,9000,28,male,25-39
18700,13750,4950,33,male,25-39
24150,12000,12150,26,male,25-39
11850,10200,1650,20,male,18-24
17700,12450,5250,38,Female,25-39
8850,8100,750,19,male,18-24
46650,11650,35000,19,female,18-24
33750,22350,11400,22,female,18-24
124150,45850,78300,21,male,18-24
40050,8200,31850,18,female,18-24
123200,42000,81200,23,male,18-24
46900,18800,28100,18,female,18-24
13750,8500,5250,18,male,18-24
11450,8200,3250,19,male,18-24
23050,11050,12000,31,male,25-39
9250,6650,2600,18,male,18-24
9400,7200,2200,19,male,18-24
31350,16150,15200,19,female,18-24
41050,18950,22100,18,female,18-24
11100,7350,3750,20,male,18-24
37350,19650,17700,18,female,18-24
47400,18050,29350,20,female,18-24
12450,7400,5050,18,male,18-24
24200,7250,16950,32,male,25-39
52750,29350,23400,24,female,18-24
16900,8100,8800,18,male,18-24
10150,6550,3600,19,male,18-24
28350,18000,10350,18,female,18-24
42200,12250,29950,18,female,18-24
37250,16450,20800,18,female,18-24
40750,14450,26300,18,female,18-24
8950,6850,2100,18,male,18-24
41400,16850,24550,18,female,18-24
28650,16850,11800,19,female,18-24
11150,10450,700,19,male,18-24
10900,10400,500,18,male,18-24
36200,17900,18300,19,female,18-24
35050,12550,22500,18,female,18-24
8400,8700,-300,37,male,25-39
45800,14100,31700,19,female,18-24
16450,10750,5700,36,Female,25-39
49300,26700,22600,21,female,18-24
26500,15150,11350,25,female,25-39
11850,7700,4150,20,male,18-24
11650,11450,200,44,female,40+
47600,20550,27050,22,female,18-24
11050,8500,2550,18,male,18-24
19950,11500,8450,31,male,25-39
9850,7750,2100,18,male,18-24
12750,7600,5150,18,male,18-24
42700,14250,28450,18,female,18-24
20950,10250,10700,28,male,25-39
114000,38750,75250,22,male,18-24
38400,18900,19500,19,female,18-24
20950,12350,8600,34,male,25-39
35100,15250,19850,19,female,18-24
11400,8150,3250,19,male,18-24
23500,17700,5800,32,Female,25-39
123500,45150,78350,21,male,18-24
23100,13100,10000,34,Female,25-39
4550,7850,-3300,18,male,18-24
19800,13350,6450,29,male,25-39
121400,36350,85050,24,male,18-24
14550,8900,5650,28,female,25-39
57100,23700,33400,22,female,18-24
7400,5850,1550,19,male,18-24
45000,14200,30800,19,female,18-24
11150,9200,1950,18,male,18-24
43700,16800,26900,24,female,18-24
39950,17900,22050,19,female,18-24
20850,12500,8350,26,female,25-39
118000,42200,75800,21,male,18-24
124250,34050,90200,21,male,18-24
9450,7850,1600,18,male,18-24
58150,13550,44600,18,female,18-24
9000,7450,1550,20,male,18-24
15000,13850,1150,26,male,25-39
10300,7900,2400,18,male,18-24
11900,6000,5900,20,male,18-24
42100,12650,29450,24,female,18-24
52200,14650,37550,22,female,18-24
106500,33750,72750,21,male,18-24
7000,9400,-2400,18,male,18-24
42150,25050,17100,24,female,18-24
46500,17900,28600,19,female,18-24
17800,14250,3550,27,female,25-39
21300,15450,5850,27,male,25-39
9250,6500,2750,18,male,18-24
10450,7650,2800,20,male,18-24
22200,9650,12550,39,male,25-39
18150,10000,8150,31,male,25-39
11550,7550,4000,18,male,18-24
10800,12000,-1200,41,female,40+
9350,7850,1500,18,male,18-24
20000,13050,6950,30,male,25-39
37100,13500,23600,18,female,18-24
21800,13050,8750,32,Female,25-39
8500,7450,1050,20,male,18-24
39900,19600,20300,19,female,18-24
10000,8350,1650,19,male,18-24
11800,8700,3100,18,male,18-24
10450,8700,1750,18,male,18-24
26400,10050,16350,33,male,25-39
34700,13750,20950,18,female,18-24
9900,7100,2800,18,male,18-24
24300,11650,12650,25,male,25-39
40100,20450,19650,21,female,18-24
8250,7500,750,20,male,18-24
11800,7900,3900,19,male,18-24
32700,16950,15750,19,female,18-24
17850,12200,5650,26,female,25-39
11350,7700,3650,18,male,18-24
32100,11750,20350,19,female,18-24
25450,14400,11050,36,Female,25-39
53750,10200,43550,18,female,18-24
40000,18050,21950,18,female,18-24
55800,21350,34450,21,female,18-24
9400,7700,1700,18,male,18-24
7950,5400,2550,18,male,18-24
8900,7700,1200,20,male,18-24
94150,38300,55850,23,male,18-24
32600,11650,20950,18,female,18-24
15400,16350,-950,37,male,25-39
18450,12950,5500,26,female,25-39
9850,8600,1250,20,male,18-24
15600,14850,750,28,male,25-39
53350,16350,37000,18,female,18-24
27500,13650,13850,18,female,18-24
10150,7600,2550,18,male,18-24
46650,16650,30000,18,female,18-24
8950,7200,1750,18,male,18-24
9150,6500,2650,18,male,18-24
42250,13250,29000,18,female,18-24
11500,8150,3350,20,male,18-24
51800,16750,35050,18,female,18-24
58900,14950,43950,21,female,18-24
10700,8550,2150,20,male,18-24
11000,12000,-1000,43,female,40+
24250,10750,13500,28,male,25-39
122900,40200,82700,23,male,18-24
105650,43050,62600,23,male,18-24
21500,10200,11300,26,male,25-39
15700,12800,2900,36,male,25-39
9100,7050,2050,18,male,18-24
8000,8400,-400,20,male,18-24
35850,10800,25050,19,female,18-24
123450,35450,88000,21,male,18-24
37650,14050,23600,18,female,18-24
19900,13500,6400,34,male,25-39
36550,17100,19450,19,female,18-24
50850,16000,34850,18,female,18-24
47950,12500,35450,19,female,18-24
6700,8700,-2000,18,male,18-24
36150,20700,15450,19,female,18-24
31750,12950,18800,19,female,18-24
8000,5850,2150,20,male,18-24
10400,9550,850,18,male,18-24
38250,12350,25900,19,female,18-24
11950,6450,5500,18,male,18-24
40600,15850,24750,18,female,18-24
36850,13600,23250,18,female,18-24
9700,7550,2150,19,male,18-24
43750,26600,17150,21,female,18-24
19300,10750,8550,35,male,25-39
49900,16850,33050,21,female,18-24
11500,8250,3250,20,male,18-24
29150,14450,14700,31,Female,25-39
8450,8200,250,19,male,18-24
14800,10750,4050,35,Female,25-39
50650,13550,37100,19,female,18-24
20850,11800,9050,25,female,25-39
9800,7500,2300,18,male,18-24
38950,14000,24950,19,female,18-24
21650,11600,10050,26,male,25-39
44550,14200,30350,19,female,18-24
7900,7750,150,20,male,18-24
47200,15250,31950,19,female,18-24
8250,8550,-300,20,male,18-24
22250,13850,8400,33,Female,25-39
8200,6800,1400,18,male,18-24
10950,8600,2350,20,male,18-24
46800,10750,36050,19,female,18-24
58200,13450,44750,24,female,18-24
19350,8900,10450,26,female,25-39
27900,11300,16600,30,male,25-39
12150,11900,250,18,male,18-24
109750,40200,69550,21,male,18-24
57000,18250,38750,21,female,18-24
41200,19850,21350,18,female,18-24
14250,13050,1200,30,male,25-39
17450,8450,9000,31,male,25-39
54150,19000,35150,22,female,18-24
30200,14250,15950,32,male,25-39
135900,38850,97050,22,male,18-24
35000,11800,23200,18,female,18-24
122800,41750,81050,22,male,18-24
6900,7550,-650,18,male,18-24
20400,9650,10750,35,Female,25-39
51350,17000,34350,18,female,18-24
121750,40750,81000,24,male,18-24
21100,13350,7750,34,male,25-39
11950,8500,3450,18,male,18-24
46450,15200,31250,18,female,18-24
9650,9800,-150,19,male,18-24
8250,8350,-100,20,male,18-24
16900,12750,4150,31,male,25-39
13900,8000,5900,20,male,18-24
125200,43900,81300,23,male,18-24
13150,10450,2700,33,Female,25-39
16300,13250,3050,36,Female,25-39
7100,6200,900,19,male,18-24
20600,15950,4650,29,male,25-39
53350,17150,36200,22,female,18-24
25400,11500,13900,35,male,25-39
11400,6650,4750,19,male,18-24
46700,20050,26650,21,female,18-24
11800,7300,4500,19,male,18-24
33650,16800,16850,18,female,18-24
16900,13750,3150,38,male,25-39
22050,14000,8050,29,male,25-39
18100,10750,7350,31,Female,25-39
43200,11050,32150,18,female,18-24
21450,12300,9150,29,FEMALE,25-39
20300,14500,5800,25,male,25-39
7500,7500,0,18,male,18-24
18900,10000,8900,29,male,25-39
42400,21150,21250,18,female,18-24
130550,39850,90700,22,male,18-24
51850,19550,32300,24,female,18-24
49850,18550,31300,18,female,18-24
5950,6100,-150,20,male,18-24
12550,10100,2450,20,male,18-24
13850,9000,4850,19,male,18-24
37450,11700,25750,19,female,18-24
11750,9000,2750,18,male,18-24
10100,11200,-1100,32,Female,25-39
34400,17100,17300,18,female,18-24
9250,7350,1900,18,male,18-24
24900,12300,12600,37,Female,25-39
124450,35300,89150,21,male,18-24
41700,23300,18400,21,female,18-24
44250,15300,28950,19,female,18-24
8050,7900,150,18,male,18-24
13750,8200,5550,19,male,18-24
15000,14650,350,33,Female,25-39
46550,24750,21800,21,female,18-24
33100,15450,17650,19,female,18-24
27900,19350,8550,19,female,18-24
10150,8250,1900,18,male,18-24
11700,6850,4850,18,male,18-24
29950,19200,10750,19,female,18-24
16150,12150,4000,36,male,25-39
138900,36050,102850,21,male,18-24
39850,17150,22700,18,female,18-24
45850,13650,32200,19,female,18-24
121600,40100,81500,21,male,18-24
10200,7200,3000,19,male,18-24
13950,6900,7050,19,male,18-24
17300,13100,4200,34,Female,25-39
38650,15950,22700,18,female,18-24
35400,19900,15500,18,female,18-24
39700,20650,19050,18,female,18-24
39900,11500,28400,18,female,18-24
8500,7850,650,19,male,18-24
13200,6600,6600,19,male,18-24
49500,22100,27400,21,female,18-24
34800,16700,18100,18,female,18-24
18950,13750,5200,26,female,25-39
22100,9950,12150,27,male,25-39
10350,8200,2150,20,male,18-24
6150,8200,-2050,20,male,18-24
40150,17800,22350,18,female,18-24
9250,8000,1250,18,male,18-24
25550,11450,14100,25,male,25-39
33050,16100,16950,18,female,18-24
39500,24100,15400,22,female,18-24
9050,8100,950,20,male,18-24
9150,8300,850,19,male,18-24
20500,10650,9850,26,female,25-39
11050,6750,4300,19,male,18-24
15900,10400,5500,30,FEMALE,25-39
41400,14500,26900,19,female,18-24
48250,14650,33600,18,female,18-24
126400,33000,93400,21,male,18-24
23550,12800,10750,33,male,25-39
40500,20100,20400,21,female,18-24
9200,7650,1550,18,male,18-24
7500,6700,800,20,male,18-24
6850,7750,-900,18,male,18-24
11200,9800,1400,20,male,18-24
47550,16250,31300,19,female,18-24
7550,9050,-1500,18,male,18-24
7950,8150,-200,19,male,18-24
9450,7200,2250,18,male,18-24
46800,21150,25650,23,female,18-24
9400,7150,2250,20,male,18-24
20950,9100,11850,27,female,25-39
47000,16050,30950,19,female,18-24
17600,10550,7050,30,male,25-39
19300,12050,7250,35,male,25-39
6600,6900,-300,18,male,18-24
10300,13250,-2950,34,male,25-39
49850,11550,38300,19,female,18-24
8900,7300,1600,20,male,18-24
13050,6950,6100,18,male,18-24
56050,12850,43200,21,female,18-24
22200,14150,8050,30,male,25-39
8300,8750,-450,20,male,18-24
21050,12500,8550,26,female,25-39
36200,10250,25950,19,female,18-24
10650,9900,750,20,male,18-24
35250,13400,21850,18,female,18-24
22550,13500,9050,30,male,25-39
42850,18850,24000,18,female,18-24
11950,9750,2200,18,male,18-24
44850,13450,31400,18,female,18-24
23350,13100,10250,30,male,25-39
21250,12600,8650,27,female,25-39
10300,7950,2350,20,male,18-24
10500,10000,500,19,male,18-24
15800,10050,5750,30,male,25-39
117550,37050,80500,21,male,18-24
13150,9050,4100,36,Female,25-39
40850,16600,24250,18,female,18-24
19300,10650,8650,32,male,25-39
53750,23450,30300,24,female,18-24
45000,23300,21700,18,female,18-24
9750,8250,1500,18,male,18-24
9400,8000,1400,19,male,18-24
20200,13100,7100,35,Female,25-39
7050,7350,-300,20,male,18-24
60100,23000,37100,21,female,18-24
22600,14250,8350,25,female,25-39
9700,9400,300,19,male,18-24
19900,7500,12400,32,male,25-39
11550,7800,3750,20,male,18-24
10950,7800,3150,19,male,18-24
6550,6250,300,20,male,18-24
29750,11950,17800,18,female,18-24
13150,8250,4900,33,male,25-39
133050,38600,94450,23,male,18-24
10150,8950,1200,19,male,18-24
9200,8600,600,18,male,18-24
16450,10600,5850,25,female,25-39
9900,7300,2600,18,male,18-24
123600,41350,82250,21,male,18-24
120000,31850,88150,21,male,18-24
10450,7250,3200,18,male,18-24
9300,8000,1300,19,male,18-24
10750,10400,350,49,female,40+
110900,43250,67650,23,male,18-24
9250,8200,1050,18,male,18-24
15850,15400,450,25,female,25-39
123700,39150,84550,21,male,18-24
35750,14150,21600,18,female,18-24
23850,13100,10750,18,female,18-24
52650,12300,40350,19,female,18-24
23100,10750,12350,39,male,25-39
15350,12650,2700,27,male,25-39
20700,11200,9500,33,male,25-39
17750,9661700,-9643950,35,male,25-39
20400,10200,10200,33,male,25-39
16850,13150,3700,33,Female,25-39
34050,13350,20700,18,female,18-24
13150,8300,4850,18,male,18-24
18100,14300,3800,31,Female,25-39
39750,9500,30250,19,female,18-24
48900,16200,32700,19,female,18-24
12300,7400,4900,18,male,18-24
9400,6850,2550,20,male,18-24
12600,10150,2450,41,male,40+
3800,8300,-4500,20,male,18-24
9750,9050,700,18,male,18-24
10000,7050,2950,18,male,18-24
40350,18500,21850,18,female,18-24
36000,15300,20700,18,female,18-24
7150,6000,1150,19,male,18-24
10800,7150,3650,19,male,18-24
49350,11650,37700,18,female,18-24
11350,6350,5000,18,male,18-24
12400,7100,5300,18,male,18-24
6650,10650,-4000,20,male,18-24
35200,17850,17350,18,female,18-24
8900,8750,150,19,male,18-24
11250,8500,2750,20,male,18-24
70650,23400,47250,21,female,18-24
12950,6900,6050,19,male,18-24
9400,5900,3500,19,male,18-24
9800,7400,2400,20,male,18-24
7150,9000,-1850,18,male,18-24
7200,8200,-1000,19,male,18-24
18850,15250,3600,31,Female,25-39
57750,18600,39150,21,female,18-24
25100,10850,14250,32,male,25-39
11150,7950,3200,20,male,18-24
17000,11800,5200,37,male,25-39
13300,14000,-700,34,Female,25-39
18850,10550,8300,30,FEMALE,25-39
21500,11700,9800,27,male,25-39
10150,7300,2850,18,male,18-24
10400,11200,-800,42,female,40+
18200,8350,9850,30,male,25-39
109450,41650,67800,21,male,18-24
38350,16900,21450,18,female,18-24
6800,8850,-2050,20,male,18-24
120850,35950,84900,24,male,18-24
20350,11900,8450,32,Female,25-39
62600,20550,42050,21,female,18-24
42950,16000,26950,18,female,18-24
9400,9800,-400,18,male,18-24
10450,7800,2650,20,male,18-24
7900,8100,-200,18,male,18-24
11100,9950,1150,18,male,18-24
124350,43500,80850,21,male,18-24
39950,15150,24800,19,female,18-24
5200,6150,-950,20,male,18-24
20000,12100,7900,38,Female,25-39
13350,13550,-200,33,male,25-39
32100,15450,16650,20,female,18-24
18450,15050,3400,27,male,25-39
4950,8550,-3600,18,male,18-24
9100,8900,200,20,male,18-24
5300,8000,-2700,19,male,18-24
119150,32350,86800,21,male,18-24
17350,13050,4300,27,male,25-39
17550,14550,3000,30,FEMALE,25-39
9900,7900,2000,20,male,18-24
75800,18700,57100,21,female,18-24
11200,11700,-500,40,male,40+
20250,15850,4400,28,FEMALE,25-39
9750,7500,2250,18,male,18-24
27550,16100,11450,19,female,18-24
34750,18650,16100,18,female,18-24
26700,15100,11600,18,female,18-24
42700,17600,25100,18,female,18-24
54550,15050,39500,21,female,18-24
59600,11600,48000,18,female,18-24
100650,41200,59450,22,male,18-24
7850,7950,-100,18,male,18-24
11900,10150,1750,20,male,18-24
8800,8150,650,19,male,18-24
10850,11700,-850,27,female,25-39
24150,12250,11900,31,male,25-39
20600,9750,10850,18,female,18-24
45300,23800,21500,21,female,18-24
54900,18850,36050,21,female,18-24
10300,6250,4050,18,male,18-24
9250,6850,2400,18,male,18-24
46800,22450,24350,22,female,18-24
7450,7750,-300,20,male,18-24
15850,9750,6100,29,male,25-39
9800,7150,2650,20,male,18-24
8500,9500,-1000,20,male,18-24
111400,39350,72050,21,male,18-24
50100,20950,29150,19,female,18-24
40850,24850,16000,21,female,18-24
10500,9650,850,18,male,18-24
20500,10550,9950,39,Female,25-39
9700,6500,3200,19,male,18-24
17450,13600,3850,25,female,25-39
26000,10900,15100,33,male,25-39
8800,7050,1750,18,male,18-24
47350,16250,31100,18,female,18-24
65000,26000,39000,21,female,18-24
32300,18900,13400,18,female,18-24
119650,37200,82450,21,male,18-24
12450,9650,2800,32,Female,25-39
8000,6950,1050,20,male,18-24
19800,10350,9450,29,FEMALE,25-39
40650,21450,19200,18,female,18-24
6500,7850,-1350,19,male,18-24
23200,13050,10150,34,Female,25-39
9950,7600,2350,19,male,18-24
38850,15500,23350,18,female,18-24
8600,7350,1250,19,male,18-24
9050,7950,1100,19,male,18-24
21750,9450,12300,27,female,25-39
9300,8400,900,19,male,18-24
11700,7300,4400,19,male,18-24
52700,19500,33200,23,female,18-24
9150,7750,1400,19,male,18-24
22800,14100,8700,29,FEMALE,25-39
36050,14800,21250,20,female,18-24
53700,24100,29600,22,female,18-24
14950,13000,1950,26,male,25-39
56850,21600,35250,18,female,18-24
11450,7000,4450,18,male,18-24
9200,8900,300,20,male,18-24
23950,14850,9100,30,FEMALE,25-39
10800,7800,3000,20,male,18-24
10600,8350,2250,19,male,18-24
26400,10550,15850,25,female,25-39
23200,12950,10250,39,male,25-39
12750,8750,4000,18,male,18-24
47000,21950,25050,21,female,18-24
67250,24000,43250,23,female,18-24
9400,8600,800,20,male,18-24
125200,44250,80950,23,male,18-24
43200,15750,27450,18,female,18-24
18850,8250,10600,30,FEMALE,25-39
32300,9950,22350,18,female,18-24
41300,15150,26150,19,female,18-24
20100,10050,10050,31,male,25-39
40050,25850,14200,21,female,18-24
53200,19550,33650,22,female,18-24
37650,17450,20200,18,female,18-24
12150,7350,4800,19,male,18-24
11150,12400,-1250,31,male,25-39
38300,18450,19850,19,female,18-24
10800,9050,1750,19,male,18-24
64100,28300,35800,21,female,18-24
43300,8350,34950,18,female,18-24
38900,8850,30050,18,female,18-24
8350,8500,-150,18,male,18-24
19200,10100,9100,27,male,25-39
22950,11100,11850,27,female,25-39
19150,11500,7650,25,male,25-39
34650,15150,19500,19,female,18-24
33950,12600,21350,19,female,18-24
24450,14250,10200,27,male,25-39
111550,40850,70700,21,male,18-24
6150,7050,-900,19,male,18-24
42550,16950,25600,18,female,18-24
25500,12300,13200,35,Female,25-39
18000,12800,5200,29,FEMALE,25-39
50700,16750,33950,24,female,18-24
15600,9200,6400,29,male,25-39
16700,12050,4650,28,FEMALE,25-39
31800,8750,23050,19,female,18-24
10500,5750,4750,19,male,18-24
9450,7950,1500,20,male,18-24
11400,7000,4400,19,male,18-24
9650,7100,2550,18,male,18-24
55150,17450,37700,22,female,18-24
45200,18700,26500,18,female,18-24
17200,14400,2800,29,FEMALE,25-39
9950,6950,3000,18,male,18-24
9100,8000,1100,20,male,18-24
42150,16200,25950,18,female,18-24
9950,9650,300,20,male,18-24
41750,14850,26900,19,female,18-24
11950,7050,4900,19,male,18-24
145250,35750,109500,21,male,18-24
20850,13000,7850,34,male,25-39
11750,8400,3350,20,male,18-24
19900,11450,8450,26,male,25-39
10300,8250,2050,18,male,18-24
20550,10800,9750,25,male,25-39
11100,8500,2600,18,male,18-24
14950,10700,4250,35,Female,25-39
12000,6050,5950,19,male,18-24
31200,8700,22500,19,female,18-24
49400,12600,36800,18,female,18-24
24350,14450,9900,39,Female,25-39
10950,7600,3350,20,male,18-24
28100,13800,14300,18,female,18-24
22150,7850,14300,35,male,25-39
32250,16250,16000,19,female,18-24
13400,14150,-750,28,male,25-39
22450,14350,8100,18,female,18-24
10900,6050,4850,18,male,18-24
9950,8700,1250,18,male,18-24
11600,7800,3800,18,male,18-24
8700,7600,1100,19,male,18-24
7550,8750,-1200,18,male,18-24
10450,10450,0,18,male,18-24
55150,16500,38650,18,female,18-24
10400,9400,1000,20,male,18-24
8000,7900,100,18,male,18-24
130100,33100,97000,21,male,18-24
11150,7450,3700,18,male,18-24
8700,8800,-100,19,male,18-24
12100,9500,2600,18,male,18-24
21000,11200,9800,27,male,25-39
19500,8550,10950,31,male,25-39
54250,25800,28450,22,female,18-24
11950,7050,4900,18,male,18-24
9650,8950,700,18,male,18-24
11950,9750,2200,18,male,18-24
37000,15150,21850,18,female,18-24
10350,8550,1800,18,male,18-24
61450,16750,44700,21,female,18-24
49200,11900,37300,18,female,18-24
13150,8650,4500,18,male,18-24
38300,12700,25600,19,female,18-24
48150,12800,35350,19,female,18-24
9750,8400,1350,20,male,18-24
12000,9550,2450,20,male,18-24
7100,8400,-1300,18,male,18-24
17250,13400,3850,34,Female,25-39
14800,8650,6150,32,male,25-39
21600,10550,11050,25,female,25-39
111150,45150,66000,21,male,18-24
13150,9350,3800,20,male,18-24
15000,11800,3200,35,Female,25-39
11500,10200,1300,40,female,40+
10900,8250,2650,20,male,18-24
6850,7000,-150,20,male,18-24
42150,12750,29400,18,female,18-24
34550,12550,22000,19,female,18-24
10100,11300,-1200,48,female,40+
115700,39400,76300,21,male,18-24
44100,11650,32450,19,female,18-24
7300,7650,-350,18,male,18-24
17600,11150,6450,30,male,25-39
8600,9750,-1150,18,male,18-24
23700,9750,13950,26,female,25-39
8550,7200,1350,19,male,18-24
17850,10700,7150,28,FEMALE,25-39
38350,11550,26800,18,female,18-24
8950,7300,1650,19,male,18-24
20450,14450,6000,36,male,25-39
22450,9600,12850,31,male,25-39
38550,16550,22000,19,female,18-24
20350,15000,5350,37,Female,25-39
37150,13650,23500,19,female,18-24
11350,7200,4150,18,male,18-24
48250,18800,29450,21,female,18-24
36200,16050,20150,18,female,18-24
17350,15950,1400,36,male,25-39
35400,13500,21900,19,female,18-24
20950,11950,9000,39,male,25-39
7850,8500,-650,18,male,18-24
44300,15500,28800,18,female,18-24
13900,7850,6050,18,male,18-24
17400,13250,4150,32,male,25-39
5650,7800,-2150,20,male,18-24
11450,6600,4850,19,male,18-24
8450,8000,450,19,male,18-24
49750,18250,31500,22,female,18-24
44550,15300,29250,19,female,18-24
20450,13400,7050,33,male,25-39
11050,7550,3500,18,male,18-24
7200,9100,-1900,19,male,18-24
8800,7550,1250,19,male,18-24
33050,11200,21850,19,female,18-24
5350,8300,-2950,18,male,18-24
48250,16700,31550,18,female,18-24
52850,14600,38250,19,female,18-24
13400,6700,6700,18,male,18-24
22650,9450,13200,34,Female,25-39
24150,9750,14400,32,Female,25-39
8450,6650,1800,20,male,18-24
22650,10900,11750,18,female,18-24
9650,9300,350,18,male,18-24
37600,19200,18400,19,female,18-24
19000,9200,9800,25,male,25-39
34550,16350,18200,18,female,18-24
10000,9400,600,20,male,18-24
48900,8150,40750,20,female,18-24
21350,10100,11250,31,Female,25-39
18250,13950,4300,36,Female,25-39
8200,8900,-700,18,male,18-24
47750,16400,31350,18,female,18-24
16850,11850,5000,33,Female,25-39
11050,7500,3550,19,male,18-24
46100,12550,33550,19,female,18-24
9700,8050,1650,18,male,18-24
7500,9050,-1550,20,male,18-24
11100,6350,4750,19,male,18-24
37500,14900,22600,18,female,18-24
9700,7950,1750,19,male,18-24
29400,12800,16600,28,male,25-39
6850,9050,-2200,20,male,18-24
8900,6850,2050,18,male,18-24
15650,18400,-2750,29,FEMALE,25-39
49400,11100,38300,18,female,18-24
100300,37550,62750,21,male,18-24
10200,7300,2900,18,male,18-24
31650,7050,24600,19,female,18-24
6850,7450,-600,19,male,18-24
7450,7750,-300,20,male,18-24
42150,11250,30900,19,female,18-24
70550,15650,54900,21,female,18-24
9050,7400,1650,19,male,18-24
15200,7400,7800,18,male,18-24
27700,10600,17100,28,FEMALE,25-39
24550,17400,7150,19,female,18-24
11350,8200,3150,18,male,18-24
126250,43450,82800,24,male,18-24
32300,15200,17100,18,female,18-24
32750,12700,20050,19,female,18-24
39750,11750,28000,19,female,18-24
15750,15600,150,31,male,25-39
8250,8100,150,18,male,18-24
19150,10600,8550,34,male,25-39
20900,10700,10200,25,male,25-39
8450,8800,-350,18,male,18-24
16100,9000,7100,27,female,25-39
49750,16950,32800,18,female,18-24
4900,7600,-2700,20,male,18-24
33600,17550,16050,18,female,18-24
48200,12350,35850,18,female,18-24
30600,12350,18250,18,female,18-24
11800,7800,4000,18,male,18-24
46550,10150,36400,18,female,18-24
7700,7750,-50,18,male,18-24
130550,40050,90500,24,male,18-24
27850,9450,18400,30,FEMALE,25-39
56400,9400,47000,21,female,18-24
43000,13100,29900,18,female,18-24
11600,11350,250,44,female,40+
30800,10850,19950,29,FEMALE,25-39
45850,14700,31150,18,female,18-24
11000,9650,1350,20,male,18-24
10100,8250,1850,18,male,18-24
16200,11000,5200,35,male,25-39
9750,5650,4100,18,male,18-24
10550,7750,2800,19,male,18-24
44400,10150,34250,18,female,18-24
9050,7650,1400,18,male,18-24
21350,15300,6050,35,Female,25-39
20450,10900,9550,33,Female,25-39
9650,8400,1250,18,male,18-24
39000,13250,25750,19,female,18-24
11950,10050,1900,19,male,18-24
10400,7300,3100,20,male,18-24
7400,5800,1600,20,male,18-24
8750,7800,950,20,male,18-24
19850,11550,8300,38,Female,25-39
27450,17600,9850,19,female,18-24
9100,9900,-800,18,male,18-24
17050,14150,2900,36,male,25-39
30950,19050,11900,18,female,18-24
32050,13400,18650,18,female,18-24
10900,7150,3750,18,male,18-24
16500,12350,4150,30,male,25-39
41700,16000,25700,19,female,18-24
18650,14750,3900,30,FEMALE,25-39
9700,5650,4050,18,male,18-24
53500,19200,34300,21,female,18-24
38150,16750,21400,19,female,18-24
18700,13450,5250,25,male,25-39
23700,13900,9800,25,female,25-39
16950,13700,3250,31,male,25-39
10050,7200,2850,18,male,18-24
8750,8100,650,19,male,18-24
4900,7200,-2300,19,male,18-24
27700,11650,16050,28,FEMALE,25-39
6750,8850,-2100,18,male,18-24
9900,7150,2750,19,male,18-24
52350,17350,35000,18,female,18-24
21200,6900,14300,31,male,25-39
13900,11600,2300,31,male,25-39
39850,13300,26550,18,female,18-24
14350,10750,3600,18,male,18-24
12100,7300,4800,18,male,18-24
8850,8100,750,18,male,18-24
117850,42550,75300,21,male,18-24
39750,10800,28950,19,female,18-24
15600,12700,2900,29,FEMALE,25-39
8500,7800,700,18,male,18-24
99700,41000,58700,24,male,18-24
11100,7750,3350,20,male,18-24
10550,8600,1950,20,male,18-24
44450,15650,28800,19,female,18-24
22100,5750,16350,27,male,25-39
10000,9900,100,45,female,40+
11950,5950,6000,19,male,18-24
30500,15950,14550,18,female,18-24
36350,13550,22800,18,female,18-24
8100,8200,-100,18,male,18-24
11550,9850,1700,18,male,18-24
33400,16200,17200,20,female,18-24
35200,14750,20450,18,female,18-24
38200,16400,21800,18,female,18-24
40950,16450,24500,18,female,18-24
8350,8650,-300,20,male,18-24
8350,8250,100,19,male,18-24
13650,8150,5500,20,male,18-24
11650,7700,3950,18,male,18-24
95550,47450,48100,22,male,18-24
5950,8750,-2800,19,male,18-24
20150,13700,6450,25,female,25-39
21750,10000,11750,38,male,25-39
19500,13650,5850,31,Female,25-39
8950,8950,0,19,male,18-24
16500,13900,2600,34,Female,25-39
13850,7300,6550,20,male,18-24
10400,9400,1000,18,male,18-24
6750,16950,-10200,33,male,25-39
10000,9100,900,20,male,18-24
30400,19550,10850,19,female,18-24
36750,13150,23600,19,female,18-24
9650,8300,1350,18,male,18-24
32050,15800,16250,18,female,18-24
124300,33250,91050,23,male,18-24
135050,46150,88900,21,male,18-24
11800,7300,4500,20,male,18-24
18250,9550,8700,26,male,25-39
38950,17900,21050,18,female,18-24
109050,47000,62050,21,male,18-24
20400,11250,9150,25,male,25-39
38650,17300,21350,18,female,18-24
10700,8250,2450,20,male,18-24
12500,7300,5200,18,male,18-24
6800,7600,-800,19,male,18-24
10850,8000,2850,19,male,18-24
19000,14500,4500,36,Female,25-39
46050,15500,30550,18,female,18-24
35300,13450,21850,19,female,18-24
40650,18550,22100,19,female,18-24
40000,8400,31600,19,female,18-24
10200,6200,4000,18,male,18-24
8500,7950,550,19,male,18-24
23150,12650,10500,35,male,25-39
9850,9700,150,18,male,18-24
11050,8850,2200,18,male,18-24
54500,16650,37850,18,female,18-24
12600,8700,3900,20,male,18-24
59900,20150,39750,21,female,18-24
19850,8700,11150,28,FEMALE,25-39
10500,8600,1900,19,male,18-24
25350,10500,14850,26,female,25-39
9100,9700,-600,19,male,18-24
11100,8800,2300,18,male,18-24
10150,8000,2150,18,male,18-24
18100,11450,6650,29,FEMALE,25-39
49200,11550,37650,19,female,18-24
21900,14600,7300,26,male,25-39
45900,13200,32700,18,female,18-24
20850,12450,8400,36,Female,25-39
8450,8450,0,18,male,18-24
49300,20300,29000,18,female,18-24
21150,10650,10500,27,female,25-39
10950,6300,4650,18,male,18-24
7750,9400,-1650,18,male,18-24
18150,14300,3850,35,male,25-39
21000,9500,11500,28,FEMALE,25-39
45400,17600,27800,21,female,18-24
29350,17350,12000,19,female,18-24
19600,9050,10550,27,male,25-39
50600,18500,32100,22,female,18-24
21500,9100,12400,29,male,25-39
12400,6950,5450,18,male,18-24
24150,11150,13000,30,FEMALE,25-39
110150,39100,71050,21,male,18-24
18900,11000,7900,30,FEMALE,25-39
42300,21650,20650,21,female,18-24
52600,16950,35650,22,female,18-24
18150,9150,9000,32,male,25-39
12900,7900,5000,19,male,18-24
44250,12400,31850,18,female,18-24
41650,11150,30500,19,female,18-24
43650,18250,25400,18,female,18-24
9700,7100,2600,18,male,18-24
40150,5700,34450,18,female,18-24
8700,6600,2100,19,male,18-24
16500,8800,7700,28,female,25-39
11050,8550,2500,19,male,18-24
11200,8100,3100,18,male,18-24
21400,7750,13650,29,FEMALE,25-39
9500,5750,3750,19,male,18-24
55100,24150,30950,21,female,18-24
50350,19450,30900,18,female,18-24
55750,17900,37850,18,female,18-24
9100,7350,1750,18,male,18-24
45700,16650,29050,19,female,18-24
6650,8500,-1850,18,male,18-24
20350,11300,9050,35,Female,25-39
45650,20150,25500,21,female,18-24
24850,12000,12850,34,male,25-39
25450,13700,11750,38,Female,25-39
11250,7850,3400,20,male,18-24
108900,45150,63750,24,male,18-24
9650,7350,2300,18,male,18-24
9750,8000,1750,19,male,18-24
10050,14450,-4400,30,FEMALE,25-39
11150,7400,3750,18,male,18-24
6450,9300,-2850,19,male,18-24
27600,11050,16550,18,female,18-24
118100,43800,74300,22,male,18-24
105800,40700,65100,21,male,18-24
14950,9550,5400,36,male,25-39
112600,36650,75950,22,male,18-24
24200,12700,11500,38,male,25-39
7900,8850,-950,19,male,18-24
20900,9100,11800,25,female,25-39
8850,8600,250,18,male,18-24
41800,13600,28200,19,female,18-24
50100,26800,23300,24,female,18-24
20200,11550,8650,29,FEMALE,25-39
10950,6350,4600,18,male,18-24
24250,8950,15300,28,male,25-39
13900,9350,4550,18,male,18-24
22550,13100,9450,25,female,25-39
9050,9600,-550,20,male,18-24
48100,14900,33200,20,female,18-24
13350,6650,6700,18,male,18-24
32750,9950,22800,18,female,18-24
11550,8200,3350,18,male,18-24
39900,20550,19350,18,female,18-24
42450,15250,27200,18,female,18-24
10850,12800,-1950,49,female,40+
10650,8050,2600,20,male,18-24
126550,39250,87300,22,male,18-24
11150,8050,3100,20,male,18-24
6750,7200,-450,18,male,18-24
37650,15900,21750,18,female,18-24
10950,6900,4050,19,male,18-24
34550,18050,16500,19,female,18-24
9250,8650,600,18,male,18-24
43800,17750,26050,18,female,18-24
59050,16500,42550,21,female,18-24
24950,10700,14250,32,Female,25-39
67400,17350,50050,22,female,18-24
48750,12350,36400,19,female,18-24
15300,11850,3450,31,Female,25-39
10000,8050,1950,19,male,18-24
12650,8450,4200,20,male,18-24
11950,7750,4200,19,male,18-24
45050,14900,30150,19,female,18-24
32250,16300,15950,18,female,18-24
20750,12150,8600,32,male,25-39
113000,39450,73550,21,male,18-24
11850,8900,2950,18,male,18-24
10800,7400,3400,19,male,18-24
40500,19300,21200,18,female,18-24
9300,8600,700,19,male,18-24
10650,8600,2050,19,male,18-24
112850,37900,74950,21,male,18-24
7150,8850,-1700,20,male,18-24
12750,9450,3300,19,male,18-24
11100,8650,2450,20,male,18-24
47900,13950,33950,19,female,18-24
12700,7200,5500,20,male,18-24
11000,8400,2600,18,male,18-24
44000,18350,25650,19,female,18-24
16700,9400,7300,35,male,25-39
35550,15750,19800,18,female,18-24
40350,17200,23150,18,female,18-24
36050,9750,26300,28,female,25-39
9050,8150,900,18,male,18-24
9950,7550,2400,18,male,18-24
7250,8450,-1200,18,male,18-24
11600,8450,3150,18,male,18-24
123200,41750,81450,21,male,18-24
21550,8450,13100,26,female,25-39
52050,15100,36950,19,female,18-24
61900,17350,44550,23,female,18-24
9750,8500,1250,20,male,18-24
8850,6600,2250,18,male,18-24
49050,23700,25350,21,female,18-24
12400,7450,4950,18,male,18-24
48000,13900,34100,18,female,18-24
8500,8250,250,20,male,18-24
12550,9500,3050,28,FEMALE,25-39
42450,15900,26550,18,female,18-24
42050,15900,26150,19,female,18-24
40950,14050,26900,18,female,18-24
19750,9250,10500,36,male,25-39
50500,15250,35250,21,female,18-24
58650,17800,40850,22,female,18-24
11450,9050,2400,19,male,18-24
42950,18750,24200,18,female,18-24
7600,9100,-1500,19,male,18-24
26150,10700,15450,25,female,25-39
6350,7550,-1200,18,male,18-24
117650,38450,79200,21,male,18-24
10500,8050,2450,19,male,18-24
29050,18700,10350,22,female,18-24
12200,6650,5550,19,male,18-24
39950,15750,24200,18,female,18-24
6600,9700,-3100,19,male,18-24
33700,19300,14400,18,female,18-24
8250,7800,450,18,male,18-24
8750,7450,1300,20,male,18-24
7150,7900,-750,18,male,18-24
43250,14750,28500,18,female,18-24
53200,25150,28050,22,female,18-24
9600,8200,1400,18,male,18-24
41550,8350,33200,19,female,18-24
132350,37350,95000,22,male,18-24
9050,7950,1100,19,male,18-24
19000,11400,7600,27,female,25-39
122350,39450,82900,23,male,18-24
49150,23900,25250,21,female,18-24
8900,6450,2450,20,male,18-24
56050,16200,39850,18,female,18-24
10800,8700,2100,19,male,18-24
37300,15350,21950,18,female,18-24
43000,18050,24950,19,female,18-24
13700,8300,5400,19,male,18-24
9200,5650,3550,18,male,18-24
13700,8350,5350,19,male,18-24
48750,18200,30550,22,female,18-24
11450,7800,3650,18,male,18-24
12300,8050,4250,18,male,18-24
11450,8650,2800,18,male,18-24
9150,7650,1500,18,male,18-24
13350,8200,5150,18,male,18-24
12050,8850,3200,18,male,18-24
53600,21800,31800,22,female,18-24
10200,10150,50,19,male,18-24
13600,13100,500,29,FEMALE,25-39
14150,8500,5650,30,male,25-39
40900,14150,26750,18,female,18-24
11450,7700,3750,20,male,18-24
21750,13800,7950,31,Female,25-39
32150,15500,16650,18,female,18-24
12600,7750,4850,18,male,18-24
21500,12250,9250,30,FEMALE,25-39
17450,15300,2150,18,female,18-24
21450,8600,12850,27,female,25-39
45650,13500,32150,18,female,18-24
4250,6400,-2150,20,male,18-24
44950,17000,27950,19,female,18-24
48550,16800,31750,20,female,18-24
7300,8550,-1250,18,male,18-24
39950,17600,22350,18,female,18-24
31050,17650,13400,18,female,18-24
21400,10900,10500,25,female,25-39
44250,13550,30700,18,female,18-24
8450,6800,1650,18,male,18-24
126750,36450,90300,21,male,18-24
33600,13700,19900,19,female,18-24
46150,16800,29350,20,female,18-24
11300,6050,5250,20,male,18-24
7000,8150,-1150,18,male,18-24
12350,7950,4400,20,male,18-24
29900,18850,11050,18,female,18-24
43300,17150,26150,22,female,18-24
7800,8900,-1100,19,male,18-24
11850,8450,3400,20,male,18-24
19050,10950,8100,39,male,25-39
29700,14250,15450,18,female,18-24
16450,8350,8100,28,FEMALE,25-39
11500,9550,1950,20,male,18-24
24150,14800,9350,30,male,25-39
9150,9150,0,19,male,18-24
11300,7550,3750,18,male,18-24
11400,8900,2500,19,male,18-24
5100,7900,-2800,18,male,18-24
21050,10450,10600,29,FEMALE,25-39
8350,10250,-1900,20,male,18-24
40100,15800,24300,18,female,18-24
8550,8750,-200,19,male,18-24
120950,38350,82600,21,male,18-24
7650,8450,-800,18,male,18-24
9500,7050,2450,18,male,18-24
7500,8150,-650,19,male,18-24
20150,8500,11650,27,male,25-39
16350,14000,2350,25,male,25-39
11150,7650,3500,18,male,18-24
9350,8350,1000,20,male,18-24
109900,42500,67400,21,male,18-24
10950,11500,-550,40,female,40+
9850,8400,1450,20,male,18-24
11150,13000,-1850,41,female,40+
9950,8550,1400,19,male,18-24
51150,12800,38350,18,female,18-24
56000,20100,35900,22,female,18-24
20150,12950,7200,33,male,25-39
8600,7950,650,19,male,18-24
23950,17600,6350,18,female,18-24
49100,20050,29050,18,female,18-24
6750,6950,-200,18,male,18-24
36050,14200,21850,18,female,18-24
19000,12550,6450,26,female,25-39
10550,8150,2400,20,male,18-24
49000,7100,41900,19,female,18-24
10000,6900,3100,19,male,18-24
52150,17750,34400,18,female,18-24
42100,17250,24850,18,female,18-24
17550,12900,4650,36,male,25-39
51000,6550,44450,19,female,18-24
36300,11100,25200,18,female,18-24
36400,12800,23600,19,female,18-24
16700,13450,3250,26,male,25-39
9800,6500,3300,19,male,18-24
56900,28400,28500,21,female,18-24
8300,9500,-1200,20,male,18-24
20350,15200,5150,27,male,25-39
12300,7650,4650,18,male,18-24
17850,15750,2100,37,Female,25-39
54700,13700,41000,19,female,18-24
15600,16350,-750,19,female,18-24
18850,11700,7150,33,male,25-39
50300,17450,32850,19,female,18-24
41000,16000,25000,19,female,18-24
39550,15500,24050,19,female,18-24
12450,8300,4150,20,male,18-24
45450,12350,33100,19,female,18-24
7500,8950,-1450,19,male,18-24
45300,15350,29950,19,female,18-24
7500,8400,-900,18,male,18-24
43000,19050,23950,19,female,18-24
8650,7650,1000,18,male,18-24
108600,36900,71700,23,male,18-24
20250,9000,11250,34,male,25-39
31450,18750,12700,20,female,18-24
10300,7800,2500,19,male,18-24
23950,9400,14550,30,male,25-39
21250,11000,10250,31,Female,25-39
17650,13050,4600,28,male,25-39
9800,7350,2450,20,male,18-24
20000,15350,4650,19,female,18-24
20800,14850,5950,38,male,25-39
117850,32150,85700,22,male,18-24
120600,43750,76850,22,male,18-24
11200,11450,-250,42,female,40+
10550,8300,2250,18,male,18-24
27850,13550,14300,18,female,18-24
24450,14600,9850,39,Female,25-39
121900,38150,83750,21,male,18-24
113950,35000,78950,21,male,18-24
20550,12300,8250,35,male,25-39
9250,8350,900,19,male,18-24
10150,8000,2150,20,male,18-24
54700,14900,39800,18,female,18-24
41300,18400,22900,19,female,18-24
29750,8400,21350,19,female,18-24
9900,7950,1950,19,male,18-24
40150,13200,26950,19,female,18-24
41500,17800,23700,18,female,18-24
18550,15950,2600,18,female,18-24
17250,12250,5000,36,Female,25-39
9800,7700,2100,18,male,18-24
8950,8650,300,19,male,18-24
109750,38500,71250,22,male,18-24
11050,7750,3300,19,male,18-24
46600,12900,33700,18,female,18-24
9850,8100,1750,18,male,18-24
8600,8100,500,18,male,18-24
24150,14700,9450,31,Female,25-39
105650,46750,58900,24,male,18-24
35250,14350,20900,18,female,18-24
20150,12650,7500,32,Female,25-39
18250,11250,7000,28,FEMALE,25-39
45900,28800,17100,23,female,18-24
25350,13700,11650,32,Female,25-39
30100,14550,15550,18,female,18-24
9750,8700,1050,18,male,18-24
40750,11800,28950,18,female,18-24
26150,11800,14350,33,male,25-39
8650,7850,800,18,male,18-24
48000,15300,32700,20,female,18-24
9800,9500,300,20,male,18-24
98200,45300,52900,23,male,18-24
24000,12300,11700,35,Female,25-39
10400,7400,3000,18,male,18-24
44100,19000,25100,18,female,18-24
49300,11350,37950,19,female,18-24
11200,7700,3500,18,male,18-24
38050,16600,21450,18,female,18-24
21650,14000,7650,27,male,25-39
10100,8150,1950,19,male,18-24
14750,12550,2200,31,Female,25-39
6950,8850,-1900,18,male,18-24
39700,15350,24350,18,female,18-24
27000,10350,16650,19,female,18-24
43900,19750,24150,19,female,18-24
11300,7800,3500,19,male,18-24
29300,11450,17850,36,Female,25-39
5900,6750,-850,18,male,18-24
10100,6250,3850,18,male,18-24
6300,6650,-350,19,male,18-24
10950,9650,1300,19,male,18-24
7400,7600,-200,18,male,18-24
24000,11900,12100,26,female,25-39
25950,7850,18100,34,Female,25-39
10450,8000,2450,18,male,18-24
36050,22250,13800,18,female,18-24
12750,8850,3900,20,male,18-24
11000,10150,850,41,female,40+
9200,6100,3100,18,male,18-24
9300,9150,150,19,male,18-24
106750,41550,65200,21,male,18-24
49750,11300,38450,19,female,18-24
5650,7250,-1600,18,male,18-24
8450,8250,200,18,male,18-24
14400,9450,4950,28,FEMALE,25-39
20550,13150,7400,33,Female,25-39
33150,15600,17550,18,female,18-24
44050,18200,25850,18,female,18-24
18550,12200,6350,34,Female,25-39
17950,8500,9450,29,male,25-39
40800,26100,14700,21,female,18-24
43450,14350,29100,19,female,18-24
23500,11550,11950,27,female,25-39
27350,14050,13300,34,male,25-39
16900,12150,4750,28,FEMALE,25-39
8150,8450,-300,20,male,18-24
54450,19050,35400,22,female,18-24
40650,11300,29350,18,female,18-24
35900,21100,14800,18,female,18-24
10750,7950,2800,18,male,18-24
13300,7650,5650,18,male,18-24
36850,25650,11200,21,female,18-24
43000,12250,30750,18,female,18-24
17650,9250,8400,30,male,25-39
19550,11150,8400,27,male,25-39
10200,6900,3300,18,male,18-24
123000,52300,70700,21,male,18-24
31800,14700,17100,18,female,18-24
36450,14600,21850,18,female,18-24
37800,21000,16800,22,female,18-24
57100,21250,35850,22,female,18-24
53550,24050,29500,22,female,18-24
21700,12650,9050,28,female,25-39
42400,14750,27650,22,female,18-24
7600,7700,-100,19,male,18-24
45050,19350,25700,24,female,18-24
25050,9500,15550,26,female,25-39
7700,6600,1100,19,male,18-24
24800,13050,11750,26,female,25-39
9950,6750,3200,20,male,18-24
11050,8350,2700,18,male,18-24
38350,15850,22500,18,female,18-24
12550,7750,4800,18,male,18-24
43950,14200,29750,18,female,18-24
11450,8100,3350,19,male,18-24
9200,8500,700,19,male,18-24
9400,8250,1150,19,male,18-24
11950,12750,-800,27,female,25-39
14850,9050,5800,19,male,18-24
21000,10300,10700,36,Female,25-39
8500,5900,2600,18,male,18-24
45800,17000,28800,18,female,18-24
13150,8300,4850,18,male,18-24
148300,44850,103450,24,male,18-24
130200,34100,96100,23,male,18-24
50200,14800,35400,19,female,18-24
10550,5650,4900,18,male,18-24
8850,8350,500,20,male,18-24
10450,8200,2250,18,male,18-24
125350,39300,86050,22,male,18-24
12300,10150,2150,41,male,40+
19300,13400,5900,26,male,25-39
13350,7550,5800,19,male,18-24
11500,10250,1250,40,female,40+
61900,14250,47650,23,female,18-24
7950,8050,-100,19,male,18-24
21700,16100,5600,36,Female,25-39
42900,15150,27750,18,female,18-24
10000,8600,1400,19,male,18-24
8100,7900,200,20,male,18-24
12750,8550,4200,18,male,18-24
12900,6900,6000,18,male,18-24
11750,6400,5350,18,male,18-24
20600,13350,7250,26,male,25-39
35650,8900,26750,18,female,18-24
9550,8050,1500,19,male,18-24
52000,18150,33850,21,female,18-24
39500,17650,21850,19,female,18-24
8450,13000,-4550,27,female,25-39
11950,7050,4900,19,male,18-24
14150,8400,5750,19,male,18-24
54150,15850,38300,22,female,18-24
19700,11450,8250,25,male,25-39
18600,15150,3450,27,male,25-39
109600,40100,69500,21,male,18-24
49750,19000,30750,23,female,18-24
11450,9300,2150,19,male,18-24
13800,8150,5650,19,male,18-24
29450,15550,13900,18,female,18-24
7300,6850,450,19,male,18-24
137350,40800,96550,21,male,18-24
54700,14750,39950,21,female,18-24
11450,8550,2900,19,male,18-24
7900,7550,350,18,male,18-24
9900,6750,3150,20,male,18-24
41400,16400,25000,18,female,18-24
8300,8600,-300,20,male,18-24
11250,6150,5100,20,male,18-24
51150,14250,36900,22,female,18-24
39750,15400,24350,20,female,18-24
110450,35000,75450,21,male,18-24
43600,20450,23150,18,female,18-24
14650,6800,7850,26,male,25-39
17750,10750,7000,18,female,18-24
42150,12500,29650,19,female,18-24
12200,13800,-1600,26,male,25-39
11450,6750,4700,18,male,18-24
15350,11650,3700,33,Female,25-39
39150,15150,24000,18,female,18-24
16100,9100,7000,28,FEMALE,25-39
19150,11250,7900,26,male,25-39
7050,7450,-400,18,male,18-24
123300,38550,84750,24,male,18-24
7650,8750,-1100,20,male,18-24
20800,10250,10550,34,Female,25-39
10000,10600,-600,40,male,40+
127100,40200,86900,21,male,18-24
23000,16950,6050,28,female,25-39
11950,9300,2650,18,male,18-24
16550,14450,2100,28,male,25-39
24000,14100,9900,33,male,25-39
19650,11850,7800,30,male,25-39
20700,14800,5900,18,female,18-24
18550,9050,9500,25,male,25-39
43250,13650,29600,18,female,18-24
17800,11100,6700,33,Female,25-39
38550,19000,19550,18,female,18-24
59200,12450,46750,18,female,18-24
36400,12600,23800,19,female,18-24
9800,8800,1000,18,male,18-24
12000,6850,5150,18,male,18-24
14150,12850,1300,35,Female,25-39
24000,12050,11950,32,male,25-39
22050,9150,12900,27,male,25-39
9500,9250,250,18,male,18-24
33550,13450,20100,18,female,18-24
25150,12450,12700,25,male,25-39
10750,7150,3600,18,male,18-24
41900,20000,21900,21,female,18-24
14700,14100,600,35,Female,25-39
119650,40700,78950,23,male,18-24
7600,8200,-600,20,male,18-24
12500,8450,4050,18,male,18-24
17600,12850,4750,30,male,25-39
9850,5950,3900,19,male,18-24
7000,8200,-1200,20,male,18-24
10700,8450,2250,18,male,18-24
48650,14500,34150,18,female,18-24
50750,16850,33900,18,female,18-24
5000,8300,-3300,18,male,18-24
45450,18400,27050,19,female,18-24
36150,13150,23000,19,female,18-24
7550,7850,-300,20,male,18-24
16050,15600,450,27,female,25-39
42000,15750,26250,18,female,18-24
10050,7950,2100,18,male,18-24
8250,10650,-2400,29,male,25-39
11200,6150,5050,20,male,18-24
19750,11950,7800,27,male,25-39
19400,13000,6400,36,male,25-39
28850,12600,16250,18,female,18-24
51450,22400,29050,21,female,18-24
9000,7150,1850,20,male,18-24
45250,11650,33600,18,female,18-24
48100,11950,36150,18,female,18-24
16550,16000,550,32,male,25-39
10100,7900,2200,18,male,18-24
13350,13100,250,35,Female,25-39
9650,6300,3350,19,male,18-24
58950,27150,31800,21,female,18-24
17850,11100,6750,33,Female,25-39
45600,16850,28750,19,female,18-24
7150,7550,-400,19,male,18-24
7650,8650,-1000,20,male,18-24
34500,13000,21500,18,female,18-24
28000,10800,17200,27,female,25-39
126050,31950,94100,21,male,18-24
16500,11250,5250,35,male,25-39
17500,15850,1650,28,male,25-39
38550,10550,28000,18,female,18-24
10700,8200,2500,18,male,18-24
53450,13300,40150,18,female,18-24
11450,7500,3950,18,male,18-24
10950,8400,2550,19,male,18-24
15000,13700,1300,36,Female,25-39
9150,7300,1850,19,male,18-24
20250,10100,10150,32,male,25-39
23550,10800,12750,27,female,25-39
10350,7300,3050,18,male,18-24
10150,12900,-2750,38,Female,25-39
37350,14050,23300,18,female,18-24
10700,8200,2500,18,male,18-24
9450,7700,1750,19,male,18-24
52400,21100,31300,22,female,18-24
15500,11700,3800,35,Female,25-39
9700,8650,1050,18,male,18-24
8850,7300,1550,19,male,18-24
11350,7550,3800,18,male,18-24
17200,14500,2700,32,male,25-39
34950,18350,16600,18,female,18-24
22200,14900,7300,27,female,25-39
22650,14450,8200,33,male,25-39
36500,20500,16000,21,female,18-24
11550,6750,4800,19,male,18-24
22850,15100,7750,20,female,18-24
17050,7850,9200,30,male,25-39
57850,15100,42750,22,female,18-24
9900,8500,1400,18,male,18-24
22800,13050,9750,30,FEMALE,25-39
25350,10800,14550,30,FEMALE,25-39
10150,7100,3050,19,male,18-24
26450,10750,15700,31,male,25-39
11000,7700,3300,19,male,18-24
43650,15650,28000,19,female,18-24
9250,6700,2550,19,male,18-24
24500,7650,16850,25,male,25-39
11750,11650,100,28,male,25-39
44850,17200,27650,18,female,18-24
35450,16800,18650,18,female,18-24
25250,15000,10250,26,male,25-39
46400,23700,22700,24,female,18-24
8100,9100,-1000,18,male,18-24
20400,11700,8700,28,male,25-39
37300,12100,25200,19,female,18-24
11100,9450,1650,18,male,18-24
20300,13200,7100,32,Female,25-39
26100,10200,15900,30,FEMALE,25-39
25100,13000,12100,31,Female,25-39
37300,17150,20150,18,female,18-24
19550,11500,8050,27,female,25-39
9000,7500,1500,20,male,18-24
14950,14150,800,32,Female,25-39
7950,10150,-2200,18,male,18-24
14800,13700,1100,32,Female,25-39
16200,13850,2350,35,Female,25-39
21400,14200,7200,27,male,25-39
114200,41400,72800,21,male,18-24
17300,13650,3650,33,Female,25-39
10500,9150,1350,19,male,18-24
45450,17350,28100,24,female,18-24
21200,10850,10350,26,male,25-39
21950,13850,8100,28,FEMALE,25-39
9300,7800,1500,19,male,18-24
51300,12850,38450,22,female,18-24
11900,8800,3100,18,male,18-24
17700,13250,4450,25,female,25-39
18000,12150,5850,28,female,25-39
25200,11400,13800,35,Female,25-39
22000,10600,11400,32,Female,25-39
63450,13950,49500,24,female,18-24
124000,38550,85450,21,male,18-24
8900,8650,250,18,male,18-24
9750,8550,1200,20,male,18-24
121500,39400,82100,22,male,18-24
15150,11300,3850,29,FEMALE,25-39
8050,8000,50,18,male,18-24
8150,9000,-850,18,male,18-24
21800,10350,11450,25,male,25-39
19400,13500,5900,31,Female,25-39
57600,25950,31650,22,female,18-24
8650,7750,900,19,male,18-24
13050,8950,4100,19,male,18-24
13000,12100,900,26,female,25-39
14100,11550,2550,30,FEMALE,25-39
10500,7750,2750,19,male,18-24
10300,8700,1600,18,male,18-24
22900,17900,5000,19,female,18-24
10700,8000,2700,19,male,18-24
27700,9750,17950,31,male,25-39
12200,7800,4400,20,male,18-24
40750,13350,27400,18,female,18-24
45050,21550,23500,18,female,18-24
34250,19250,15000,21,female,18-24
128950,47150,81800,22,male,18-24
10000,9400,600,18,male,18-24
9000,5750,3250,20,male,18-24
28650,17350,11300,19,female,18-24
27250,12900,14350,18,female,18-24
11750,7750,4000,19,male,18-24
20650,12200,8450,37,male,25-39
11450,6950,4500,18,male,18-24
38300,21750,16550,19,female,18-24
8900,8850,50,18,male,18-24
43800,18500,25300,18,female,18-24
50250,13550,36700,18,female,18-24
11500,11300,200,43,female,40+
43100,18300,24800,19,female,18-24
21800,10700,11100,28,female,25-39
31550,12250,19300,18,female,18-24
126000,33250,92750,21,male,18-24
12150,6700,5450,20,male,18-24
27250,17950,9300,19,female,18-24
17300,13150,4150,36,Female,25-39
39600,10650,28950,20,female,18-24
8250,8150,100,19,male,18-24
15700,15000,700,33,Female,25-39
14350,6750,7600,18,male,18-24
35850,22150,13700,21,female,18-24
16400,10700,5700,30,FEMALE,25-39
42650,8150,34500,19,female,18-24
8850,10500,-1650,18,male,18-24
32150,16100,16050,18,female,18-24
24800,12950,11850,38,male,25-39
29000,16450,12550,19,female,18-24
29250,12600,16650,33,Female,25-39
10600,7100,3500,20,male,18-24
9300,6550,2750,19,male,18-24
22950,13700,9250,29,male,25-39
24250,8750,15500,36,Female,25-39
8400,9150,-750,18,male,18-24
23150,14650,8500,36,male,25-39
10750,8450,2300,18,male,18-24
51950,14850,37100,18,female,18-24
10500,6300,4200,18,male,18-24
10400,8500,1900,20,male,18-24
38950,18350,20600,18,female,18-24
12550,8400,4150,20,male,18-24
10150,7650,2500,19,male,18-24
44450,10150,34300,18,female,18-24
12650,5600,7050,19,male,18-24
8350,6150,2200,18,male,18-24
9400,8500,900,18,male,18-24
7900,7800,100,18,male,18-24
41000,17000,24000,18,female,18-24
50000,21350,28650,21,female,18-24
9750,8250,1500,18,male,18-24
13250,8100,5150,20,male,18-24
106000,42300,63700,21,male,18-24
19500,10700,8800,33,Female,25-39
22950,12900,10050,38,male,25-39
8700,8650,50,19,male,18-24
124650,38950,85700,21,male,18-24
11100,12600,-1500,38,Female,25-39
39200,15400,23800,19,female,18-24
53350,26600,26750,24,female,18-24
6800,9100,-2300,18,male,18-24
22500,13400,9100,25,male,25-39
16100,13950,2150,25,female,25-39
10800,8200,2600,18,male,18-24
23650,12250,11400,32,male,25-39
11600,9500,2100,26,female,25-39
10800,11300,-500,28,male,25-39
21250,10850,10400,30,male,25-39
29500,7900,21600,28,FEMALE,25-39
14150,11650,2500,30,FEMALE,25-39
11900,6700,5200,20,male,18-24
28050,19300,8750,18,female,18-24
31900,15250,16650,19,female,18-24
122450,41000,81450,21,male,18-24
8750,7300,1450,20,male,18-24
21950,11200,10750,31,male,25-39
21350,12500,8850,34,male,25-39
37300,16650,20650,18,female,18-24
22750,13550,9200,33,Female,25-39
26150,14900,11250,35,male,25-39
40950,25200,15750,24,female,18-24
44500,19100,25400,18,female,18-24
17650,13600,4050,32,Female,25-39
12100,7600,4500,20,male,18-24
26250,11500,14750,34,Female,25-39
42100,16100,26000,19,female,18-24
32350,18600,13750,18,female,18-24
50150,16100,34050,19,female,18-24
18000,8150,9850,31,Female,25-39
39650,15650,24000,18,female,18-24
41300,17850,23450,18,female,18-24
58800,26100,32700,21,female,18-24
10450,7050,3400,18,male,18-24
44600,18750,25850,19,female,18-24
8700,8950,-250,18,male,18-24
22050,12100,9950,31,male,25-39
11100,6350,4750,19,male,18-24
43850,13500,30350,21,female,18-24
17250,8100,9150,31,male,25-39
10800,7150,3650,18,male,18-24
34600,15100,19500,18,female,18-24
12200,7000,5200,19,male,18-24
19750,9050,10700,31,Female,25-39
22150,11150,11000,34,Female,25-39
35350,9150,26200,18,female,18-24
22250,16700,5550,18,female,18-24
12400,8200,4200,18,male,18-24
6500,5200,1300,18,male,18-24
7050,8850,-1800,20,male,18-24
21100,9050,12050,33,Female,25-39
12500,7050,5450,18,male,18-24
23200,10400,12800,37,Female,25-39
31650,19000,12650,18,female,18-24
22250,10400,11850,35,male,25-39
112400,39650,72750,22,male,18-24
38950,14200,24750,19,female,18-24
17200,14400,2800,25,male,25-39
16100,10350,5750,25,female,25-39
13450,8750,4700,29,male,25-39
10750,7350,3400,18,male,18-24
7850,8800,-950,18,male,18-24
51750,14600,37150,21,female,18-24
16900,10900,6000,29,male,25-39
32000,9650,22350,19,female,18-24
36850,11100,25750,19,female,18-24
15250,10650,4600,25,female,25-39
12350,8450,3900,18,male,18-24
13900,9950,3950,25,female,25-39
42000,17650,24350,21,female,18-24
7850,8550,-700,19,male,18-24
23950,14650,9300,32,Female,25-39
18700,10450,8250,25,female,25-39
8750,7100,1650,19,male,18-24
33400,20850,12550,18,female,18-24
11400,8500,2900,18,male,18-24
17350,11900,5450,31,male,25-39
111800,40000,71800,23,male,18-24
16800,14600,2200,33,Female,25-39
54150,11300,42850,19,female,18-24
18000,11050,6950,33,male,25-39
10800,6400,4400,18,male,18-24
11750,10650,1100,41,female,40+
10000,7450,2550,18,male,18-24
11050,8050,3000,20,male,18-24
10400,8200,2200,19,male,18-24
26200,12600,13600,26,female,25-39
9500,8150,1350,18,male,18-24
46350,19400,26950,21,female,18-24
10150,6200,3950,19,male,18-24
46950,12500,34450,18,female,18-24
39900,16800,23100,19,female,18-24
128300,33250,95050,21,male,18-24
10650,7950,2700,20,male,18-24
47450,24100,23350,24,female,18-24
15400,13200,2200,36,Female,25-39
21300,12950,8350,30,male,25-39
46550,22950,23600,21,female,18-24
19000,14100,4900,29,male,25-39
44100,18700,25400,18,female,18-24
17500,12600,4900,30,male,25-39
23650,9700,13950,39,male,25-39
8200,7400,800,19,male,18-24
13650,8250,5400,19,male,18-24
13450,6550,6900,18,male,18-24
7600,9050,-1450,18,male,18-24
6450,6400,50,19,male,18-24
16750,13800,2950,30,FEMALE,25-39
52250,14500,37750,21,female,18-24
21950,9500,12450,34,male,25-39
11650,7050,4600,18,male,18-24
10700,5950,4750,18,male,18-24
9950,7100,2850,20,male,18-24
7500,6300,1200,19,male,18-24
37300,15250,22050,18,female,18-24
21800,9000,12800,28,male,25-39
16550,14000,2550,30,male,25-39
12500,7600,4900,18,male,18-24
130250,36950,93300,21,male,18-24
18000,9450,8550,32,male,25-39
47200,17250,29950,18,female,18-24
12550,7350,5200,18,male,18-24
14050,9650,4400,31,Female,25-39
32500,15800,16700,18,female,18-24
7850,6750,1100,18,male,18-24
47250,16200,31050,19,female,18-24
17050,11350,5700,27,female,25-39
12550,7550,5000,18,male,18-24
10650,8550,2100,41,male,40+
32850,19500,13350,19,female,18-24
8050,8150,-100,20,male,18-24
13000,8650,4350,18,male,18-24
8050,7750,300,18,male,18-24
47950,28500,19450,21,female,18-24
41600,14150,27450,19,female,18-24
122700,39750,82950,21,male,18-24
51750,12900,38850,21,female,18-24
15200,12850,2350,37,Female,25-39
37700,20050,17650,18,female,18-24
11200,6450,4750,18,male,18-24
119400,38300,81100,21,male,18-24
17800,11900,5900,39,Female,25-39
16750,10050,6700,27,female,25-39
22400,11000,11400,29,FEMALE,25-39
49450,19900,29550,18,female,18-24
20550,10800,9750,26,male,25-39
11150,7500,3650,20,male,18-24
12300,6950,5350,19,male,18-24
13350,8100,5250,19,male,18-24
20250,11700,8550,37,Female,25-39
12850,9450,3400,36,Female,25-39
26800,7300,19500,31,Female,25-39
9150,12100,-2950,33,male,25-39
13500,9050,4450,18,male,18-24
29600,11250,18350,36,male,25-39
10150,9350,800,19,male,18-24
35600,20200,15400,18,female,18-24
19400,13950,5450,37,male,25-39
39450,17850,21600,19,female,18-24
24050,13150,10900,36,male,25-39
12100,7500,4600,20,male,18-24
40200,13450,26750,20,female,18-24
24250,12850,11400,32,Female,25-39
18450,14150,4300,25,female,25-39
13550,9000,4550,18,male,18-24
33850,12650,21200,19,female,18-24
46450,13500,32950,19,female,18-24
14300,9050,5250,20,male,18-24
37100,11950,25150,18,female,18-24
11350,9650,1700,19,male,18-24
19300,11850,7450,30,FEMALE,25-39
9600,9550,50,20,male,18-24
19400,9650,9750,32,Female,25-39
21400,10550,10850,27,male,25-39
19750,13250,6500,35,male,25-39
43850,12750,31100,19,female,18-24
8150,7950,200,18,male,18-24
14200,8150,6050,26,female,25-39
39200,17550,21650,19,female,18-24
14100,11400,2700,35,Female,25-39
47150,17850,29300,22,female,18-24
24150,13450,10700,28,female,25-39
11750,6800,4950,18,male,18-24
21450,11700,9750,35,Female,25-39
12050,10150,1900,25,female,25-39
15900,12300,3600,36,male,25-39
27500,16200,11300,18,female,18-24
14800,12050,2750,26,female,25-39
12700,7400,5300,18,male,18-24
10100,12650,-2550,40,female,40+
12000,8950,3050,20,male,18-24
19750,13300,6450,26,male,25-39
17200,11750,5450,28,male,25-39
19500,13100,6400,30,male,25-39
10500,8400,2100,18,male,18-24
56150,24850,31300,21,female,18-24
12200,8200,4000,19,male,18-24
22150,14250,7900,34,Female,25-39
19850,10300,9550,26,male,25-39
9700,8650,1050,18,male,18-24
10800,6900,3900,20,male,18-24
8700,7550,1150,18,male,18-24
8550,7300,1250,19,male,18-24
24750,10900,13850,28,male,25-39
57450,21100,36350,22,female,18-24
12650,8150,4500,18,male,18-24
64500,17300,47200,21,female,18-24
20850,14150,6700,34,male,25-39
12150,6700,5450,18,male,18-24
11300,6900,4400,19,male,18-24
38200,21700,16500,18,female,18-24
9450,7650,1800,18,male,18-24
121500,43800,77700,21,male,18-24
22550,10550,12000,35,Female,25-39
8900,7750,1150,20,male,18-24
11750,9050,2700,18,male,18-24
9200,7000,2200,18,male,18-24
120000,41800,78200,21,male,18-24
7750,9150,-1400,20,male,18-24
17450,13700,3750,33,male,25-39
10200,8700,1500,18,male,18-24
11250,6100,5150,18,male,18-24
18000,12100,5900,30,FEMALE,25-39
20600,14800,5800,28,female,25-39
10600,6800,3800,20,male,18-24
27050,11100,15950,28,male,25-39
19350,11450,7900,28,male,25-39
12600,8650,3950,18,male,18-24
7200,9600,-2400,19,male,18-24
18550,14350,4200,30,FEMALE,25-39
53550,20750,32800,21,female,18-24
21450,11900,9550,25,male,25-39
63350,22150,41200,22,female,18-24
131050,43100,87950,23,male,18-24
19800,8600,11200,32,male,25-39
43250,18400,24850,19,female,18-24
50350,20300,30050,21,female,18-24
16250,13650,2600,30,Female,25-39
11750,7900,3850,18,male,18-24
18950,9100,9850,31,male,25-39
42650,13950,28700,18,female,18-24
9800,8350,1450,19,male,18-24
60450,8100,52350,19,female,18-24
123350,34900,88450,21,male,18-24
119650,37800,81850,22,male,18-24
43750,18850,24900,18,female,18-24
125450,39250,86200,21,male,18-24
7600,8650,-1050,20,male,18-24
9950,8200,1750,20,male,18-24
20550,10600,9950,27,male,25-39
7200,6950,250,18,male,18-24
12750,7550,5200,18,male,18-24
10600,7800,2800,19,male,18-24
50550,16250,34300,18,female,18-24
28100,10650,17450,25,female,25-39
25450,12500,12950,32,Female,25-39
8450,9250,-800,19,male,18-24
45550,21450,24100,21,female,18-24
18850,12900,5950,33,Female,25-39
9650,7300,2350,18,male,18-24
7600,8950,-1350,18,male,18-24
22450,10900,11550,31,Female,25-39
10450,11350,-900,42,female,40+
12800,13800,-1000,27,female,25-39
45550,20350,25200,18,female,18-24
51200,10250,40950,19,female,18-24
23050,12800,10250,34,male,25-39
11050,9600,1450,18,male,18-24
30650,17550,13100,18,female,18-24
106550,39650,66900,24,male,18-24
11300,5250,6050,20,male,18-24
10700,6950,3750,18,male,18-24
9300,8350,950,19,male,18-24
20350,12100,8250,34,Female,25-39
59550,19900,39650,24,female,18-24
20150,12200,7950,29,FEMALE,25-39
55800,14950,40850,18,female,18-24
21150,7200,13950,36,male,25-39
47550,22150,25400,21,female,18-24
10550,8600,1950,20,male,18-24
44300,12050,32250,19,female,18-24
7550,7500,50,20,male,18-24
39400,17350,22050,18,female,18-24
10300,8000,2300,18,male,18-24
19400,10450,8950,32,male,25-39
43100,14350,28750,19,female,18-24
17350,11050,6300,30,male,25-39
17450,11400,6050,25,male,25-39
58450,22600,35850,21,female,18-24
19600,8800,10800,30,male,25-39
8950,9250,-300,20,male,18-24
10800,8350,2450,20,male,18-24
16650,11400,5250,25,female,25-39
25300,16950,8350,26,male,25-39
7900,7750,150,18,male,18-24
12100,6300,5800,19,male,18-24
9450,8600,850,18,male,18-24
7800,8600,-800,18,male,18-24
43150,12750,30400,19,female,18-24
64350,17300,47050,21,female,18-24
20100,11800,8300,35,male,25-39
22000,10800,11200,26,female,25-39
19100,8350,10750,36,male,25-39
40200,17400,22800,19,female,18-24
7150,9700,-2550,18,male,18-24
49250,10500,38750,18,female,18-24
9200,6500,2700,18,male,18-24
23000,13050,9950,35,Female,25-39
5450,8250,-2800,18,male,18-24
9700,7800,1900,18,male,18-24
100350,39550,60800,22,male,18-24
42050,12000,30050,18,female,18-24
35600,13850,21750,19,female,18-24
39750,16250,23500,19,female,18-24
30000,15300,14700,18,female,18-24
22200,10850,11350,27,male,25-39
11700,9050,2650,18,male,18-24
17400,13150,4250,26,male,25-39
53250,19650,33600,21,female,18-24
12100,13050,-950,34,Female,25-39
13150,12650,500,33,Female,25-39
11200,7050,4150,19,male,18-24
119800,44600,75200,22,male,18-24
20900,11650,9250,37,Female,25-39
40100,18500,21600,18,female,18-24
4850,9700,-4850,19,male,18-24
12000,7250,4750,18,male,18-24
51050,13850,37200,19,female,18-24
8450,8200,250,20,male,18-24
18100,6800,11300,37,Female,25-39
42950,21300,21650,18,female,18-24
21950,14100,7850,26,male,25-39
9500,7850,1650,18,male,18-24
10350,6850,3500,20,male,18-24
21500,8950,12550,29,FEMALE,25-39
12050,7950,4100,20,male,18-24
40850,14350,26500,20,female,18-24
5450,6600,-1150,18,male,18-24
7900,8150,-250,20,male,18-24
10800,7000,3800,18,male,18-24
103350,42700,60650,21,male,18-24
64850,18950,45900,23,female,18-24
24700,13050,11650,31,male,25-39
7000,9350,-2350,20,male,18-24
47750,20600,27150,24,female,18-24
41300,18200,23100,19,female,18-24
13400,15500,-2100,32,male,25-39
6100,7700,-1600,18,male,18-24
10950,7100,3850,18,male,18-24
9750,7800,1950,18,male,18-24
9950,8050,1900,19,male,18-24
9300,8250,1050,18,male,18-24
11100,6750,4350,18,male,18-24
19900,14400,5500,26,male,25-39
12700,7850,4850,18,male,18-24
19350,11900,7450,27,male,25-39
7100,9150,-2050,19,male,18-24
18550,14550,4000,35,male,25-39
22000,11150,10850,37,male,25-39
32050,15550,16500,18,female,18-24
25350,12550,12800,34,male,25-39
22350,16150,6200,26,female,25-39
16100,10450,5650,26,female,25-39
9650,7800,1850,18,male,18-24
24000,14150,9850,39,male,25-39
116550,41250,75300,21,male,18-24
50950,20000,30950,19,female,18-24
39900,15200,24700,19,female,18-24
9100,8450,650,18,male,18-24
46100,12050,34050,19,female,18-24
11600,7600,4000,18,male,18-24
26150,15550,10600,18,female,18-24
9250,8700,550,19,male,18-24
12350,6800,5550,18,male,18-24
31750,14400,17350,19,female,18-24
5450,7600,-2150,18,male,18-24
9800,9700,100,18,male,18-24
19800,12800,7000,26,female,25-39
15900,10600,5300,28,male,25-39
9500,8850,650,18,male,18-24
15300,10350,4950,31,Female,25-39
17650,13750,3900,28,female,25-39
12900,7200,5700,19,male,18-24
11600,7500,4100,18,male,18-24
51500,16850,34650,21,female,18-24
24350,12900,11450,36,male,25-39
11500,10350,1150,18,male,18-24
43550,15650,27900,18,female,18-24
51050,16100,34950,18,female,18-24
39000,14200,24800,19,female,18-24
13550,8200,5350,19,male,18-24
10550,8050,2500,19,male,18-24
50650,11650,39000,18,female,18-24
22500,10650,11850,29,FEMALE,25-39
31900,14400,17500,18,female,18-24
35100,11750,23350,18,female,18-24
7350,6500,850,18,male,18-24
7650,8550,-900,18,male,18-24
13100,8050,5050,18,male,18-24
7050,7850,-800,19,male,18-24
38650,12050,26600,19,female,18-24
7800,9000,-1200,18,male,18-24
135450,38750,96700,21,male,18-24
20400,9150,11250,34,male,25-39
22850,10050,12800,36,Female,25-39
10750,7600,3150,18,male,18-24
9750,7400,2350,19,male,18-24
46400,15350,31050,18,female,18-24
26050,15900,10150,18,female,18-24
17150,13700,3450,29,male,25-39
33800,23900,9900,24,female,18-24
22300,12300,10000,35,male,25-39
9450,8050,1400,19,male,18-24
10600,8250,2350,20,male,18-24
18050,13150,4900,30,male,25-39
6050,9600,-3550,18,male,18-24
10300,6950,3350,18,male,18-24
19950,15600,4350,38,Female,25-39
15400,11800,3600,31,Female,25-39
37200,14750,22450,18,female,18-24
47500,14350,33150,18,female,18-24
10350,9200,1150,19,male,18-24
19600,14500,5100,30,FEMALE,25-39
28400,13900,14500,30,male,25-39
18100,13200,4900,25,male,25-39
10750,7650,3100,19,male,18-24
22400,12450,9950,30,FEMALE,25-39
25500,12250,13250,30,FEMALE,25-39
23550,11300,12250,33,Female,25-39
10750,6750,4000,19,male,18-24
98250,42700,55550,21,male,18-24
115200,41600,73600,21,male,18-24
19850,13250,6600,37,Female,25-39
31300,15550,15750,18,female,18-24
104000,37250,66750,22,male,18-24
37150,12050,25100,19,female,18-24
23100,9700,13400,32,male,25-39
10350,6700,3650,18,male,18-24
29800,16850,12950,18,female,18-24
10950,6050,4900,18,male,18-24
8850,9400,-550,18,male,18-24
110100,40600,69500,21,male,18-24
10850,8150,2700,20,male,18-24
6750,8000,-1250,20,male,18-24
10650,8900,1750,18,male,18-24
9850,7450,2400,18,male,18-24
41650,20050,21600,22,female,18-24
15050,6900,8150,18,male,18-24
8900,7750,1150,18,male,18-24
22550,12050,10500,32,Female,25-39
40500,17400,23100,19,female,18-24
45250,15750,29500,18,female,18-24
8350,8400,-50,19,male,18-24
34450,12050,22400,18,female,18-24
111350,41650,69700,22,male,18-24
44250,22000,22250,21,female,18-24
10700,8150,2550,20,male,18-24
25650,13200,12450,36,male,25-39
30100,14150,15950,18,female,18-24
40050,19200,20850,19,female,18-24
12900,7400,5500,20,male,18-24
7250,7800,-550,18,male,18-24
17150,13850,3300,25,female,25-39
95050,48300,46750,23,male,18-24
18100,12000,6100,30,FEMALE,25-39
11400,8700,2700,18,male,18-24
11900,8050,3850,18,male,18-24
11950,9800,2150,18,male,18-24
9950,10050,-100,19,male,18-24
12900,6150,6750,18,male,18-24
109350,41500,67850,21,male,18-24
23250,12600,10650,36,Female,25-39
16450,12700,3750,28,male,25-39
22600,9850,12750,32,male,25-39
35800,15700,20100,18,female,18-24
8500,8100,400,18,male,18-24
19350,13650,5700,25,male,25-39
20400,10150,10250,32,male,25-39
51400,11550,39850,18,female,18-24
25400,14050,11350,29,male,25-39
30250,13400,16850,18,female,18-24
9350,6150,3200,18,male,18-24
6500,10300,-3800,19,male,18-24
10800,10800,0,43,male,40+
18850,13950,4900,25,male,25-39
12600,7200,5400,19,male,18-24
22800,8900,13900,32,Female,25-39
24600,12550,12050,28,male,25-39
9700,6750,2950,19,male,18-24
55950,14700,41250,19,female,18-24
9650,6650,3000,18,male,18-24
59900,21600,38300,24,female,18-24
31600,16150,15450,18,female,18-24
43000,17650,25350,19,female,18-24
8000,7300,700,20,male,18-24
13550,7500,6050,18,male,18-24
21300,11250,10050,32,Female,25-39
41550,9900,31650,18,female,18-24
11200,7250,3950,18,male,18-24
20400,11250,9150,38,Female,25-39
10800,7100,3700,18,male,18-24
20150,9750,10400,25,male,25-39
35950,17200,18750,18,female,18-24
31950,14650,17300,19,female,18-24
40900,10100,30800,20,female,18-24
106300,39150,67150,21,male,18-24
9600,7650,1950,18,male,18-24
47000,10700,36300,18,female,18-24
8000,6600,1400,19,male,18-24
17400,16500,900,19,female,18-24
41350,17300,24050,18,female,18-24
20950,13200,7750,37,Female,25-39
12750,9050,3700,18,male,18-24
11500,7850,3650,20,male,18-24
51250,18650,32600,19,female,18-24
9850,8250,1600,19,male,18-24
58400,17100,41300,18,female,18-24
55550,22600,32950,21,female,18-24
9850,7450,2400,20,male,18-24
20750,10300,10450,35,Female,25-39
8500,8050,450,20,male,18-24
9100,7650,1450,18,male,18-24
89050,33800,55250,21,male,18-24
17600,10600,7000,32,Female,25-39
23750,13150,10600,36,male,25-39
51350,20350,31000,21,female,18-24
20100,11900,8200,34,Female,25-39
111600,42250,69350,21,male,18-24
8900,7800,1100,18,male,18-24
50850,16250,34600,18,female,18-24
44650,22550,22100,24,female,18-24
20600,10300,10300,34,male,25-39
13400,7900,5500,19,male,18-24
37500,22200,15300,19,female,18-24
19050,11950,7100,27,female,25-39
39200,17400,21800,19,female,18-24
20600,14350,6250,33,Female,25-39
10250,8150,2100,19,male,18-24
18700,13450,5250,28,female,25-39
119050,39100,79950,21,male,18-24
35850,12900,22950,18,female,18-24
17800,12650,5150,33,Female,25-39
17300,13550,3750,28,male,25-39
38850,17100,21750,18,female,18-24
35050,18750,16300,19,female,18-24
10400,8800,1600,18,male,18-24
9550,8000,1550,19,male,18-24
9200,7450,1750,20,male,18-24
11400,7000,4400,18,male,18-24
37550,10400,27150,19,female,18-24
35850,18100,17750,18,female,18-24
10150,8050,2100,19,male,18-24
16500,10950,5550,29,male,25-39
10100,8900,1200,20,male,18-24
13250,8400,4850,19,male,18-24
12050,9500,2550,19,male,18-24
60700,15550,45150,24,female,18-24
37100,16150,20950,18,female,18-24
12050,7300,4750,18,male,18-24
14600,8700,5900,19,male,18-24
38000,15150,22850,18,female,18-24
23600,12600,11000,39,Female,25-39
123000,38700,84300,21,male,18-24
13300,8800,4500,18,male,18-24
18100,11400,6700,32,Female,25-39
48300,13400,34900,19,female,18-24
55350,18800,36550,21,female,18-24
34400,14250,20150,19,female,18-24
12150,9850,2300,20,male,18-24
11200,8300,2900,20,male,18-24
23150,10950,12200,25,female,25-39
17650,11450,6200,38,Female,25-39
9400,7550,1850,19,male,18-24
9400,9400,0,19,male,18-24
7250,6350,900,19,male,18-24
41500,12750,28750,18,female,18-24
10550,7400,3150,20,male,18-24
10600,8500,2100,19,male,18-24
11000,7850,3150,18,male,18-24
30950,15650,15300,18,female,18-24
9200,8850,350,20,male,18-24
28650,8150,20500,25,female,25-39
20400,10900,9500,28,female,25-39
11550,12900,-1350,45,female,40+
17050,14550,2500,27,female,25-39
21750,14700,7050,18,female,18-24
11300,7500,3800,20,male,18-24
9100,7900,1200,18,male,18-24
18900,11050,7850,26,female,25-39
10100,8600,1500,20,male,18-24
6350,8650,-2300,19,male,18-24
38400,15400,23000,19,female,18-24
10650,10500,150,43,male,40+
23800,8450,15350,36,Female,25-39
107200,41100,66100,21,male,18-24
17350,11000,6350,28,FEMALE,25-39
10150,7200,2950,20,male,18-24
9700,7250,2450,19,male,18-24
10200,8450,1750,20,male,18-24
47650,12800,34850,22,female,18-24
42700,19650,23050,19,female,18-24
54350,17050,37300,20,female,18-24
9350,7150,2200,20,male,18-24
21150,9800,11350,26,male,25-39
108350,36200,72150,21,male,18-24
12750,7000,5750,18,male,18-24
58100,25000,33100,21,female,18-24
11300,7150,4150,19,male,18-24
17750,13550,4200,31,male,25-39
45750,17100,28650,18,female,18-24
14600,14100,500,25,female,25-39
10100,7650,2450,18,male,18-24
10050,15950,-5900,27,male,25-39
6450,9200,-2750,18,male,18-24
35600,17700,17900,18,female,18-24
18050,12350,5700,25,male,25-39
17800,11800,6000,39,Female,25-39
10350,7650,2700,18,male,18-24
47100,9600,37500,19,female,18-24
9700,7250,2450,18,male,18-24
26650,14300,12350,36,male,25-39
20750,13350,7400,28,female,25-39
10100,8950,1150,18,male,18-24
38100,16350,21750,19,female,18-24
9950,7850,2100,19,male,18-24
41450,14550,26900,18,female,18-24
45550,15800,29750,21,female,18-24
20800,13050,7750,28,female,25-39
10950,11950,-1000,41,female,40+
14100,13350,750,36,Female,25-39
7650,8150,-500,18,male,18-24
11750,7150,4600,18,male,18-24
18500,12250,6250,33,male,25-39
15900,10450,5450,29,FEMALE,25-39
54750,18100,36650,18,female,18-24
24250,12850,11400,31,Female,25-39
25500,14500,11000,18,female,18-24
17400,9150,8250,28,FEMALE,25-39
15650,12900,2750,27,male,25-39
18200,11100,7100,26,female,25-39
21450,10500,10950,31,male,25-39
19950,13200,6750,29,FEMALE,25-39
136250,39050,97200,21,male,18-24
48950,15300,33650,18,female,18-24
16050,9850,6200,32,Female,25-39
42550,19900,22650,18,female,18-24
8000,9500,-1500,18,male,18-24
21750,12550,9200,29,FEMALE,25-39
11600,10400,1200,18,male,18-24
10600,8050,2550,18,male,18-24
10800,8800,2000,19,male,18-24
16000,12800,3200,25,male,25-39
9750,9300,450,19,male,18-24
21050,11150,9900,25,female,25-39
52750,22550,30200,21,female,18-24
105900,39950,65950,21,male,18-24
11050,8150,2900,20,male,18-24
25000,12450,12550,38,Female,25-39
11750,7850,3900,18,male,18-24
7800,8850,-1050,18,male,18-24
42700,15750,26950,18,female,18-24
127550,35850,91700,21,male,18-24
38400,15700,22700,18,female,18-24
10850,7300,3550,19,male,18-24
35350,19900,15450,19,female,18-24
7850,8000,-150,19,male,18-24
8500,7750,750,20,male,18-24
9500,6400,3100,19,male,18-24
40100,16350,23750,18,female,18-24
19650,10200,9450,31,Female,25-39
8450,6050,2400,19,male,18-24
10850,8800,2050,19,male,18-24
10000,7750,2250,20,male,18-24
17350,10100,7250,31,Female,25-39
18300,13050,5250,39,Female,25-39
18500,11500,7000,25,female,25-39
9150,8150,1000,18,male,18-24
29100,11900,17200,33,Female,25-39
60700,22100,38600,21,female,18-24
24500,13250,11250,35,Female,25-39
10350,8550,1800,19,male,18-24
124550,36500,88050,22,male,18-24
55950,12350,43600,19,female,18-24
18300,13050,5250,39,Female,25-39
8750,7600,1150,20,male,18-24
10450,6950,3500,19,male,18-24
50800,24100,26700,22,female,18-24
42000,10450,31550,18,female,18-24
10400,8500,1900,20,male,18-24
9800,5700,4100,20,male,18-24
26350,13750,12600,31,male,25-39
18500,11100,7400,27,female,25-39
10650,8600,2050,18,male,18-24
26350,12250,14100,39,male,25-39
20550,12850,7700,37,male,25-39
10500,7950,2550,18,male,18-24
10600,7700,2900,19,male,18-24
16200,16400,-200,29,male,25-39
63450,11100,52350,19,female,18-24
8350,8400,-50,19,male,18-24
8950,7700,1250,20,male,18-24
23400,9000,14400,32,male,25-39
15850,16350,-500,27,female,25-39
19450,13350,6100,18,female,18-24
51500,15000,36500,23,female,18-24
16400,8050,8350,18,male,18-24
11900,7850,4050,20,male,18-24
39450,10350,29100,19,female,18-24
17700,15100,2600,37,male,25-39
10600,7850,2750,18,male,18-24
12900,6900,6000,19,male,18-24
13150,9750,3400,20,male,18-24
28400,10150,18250,20,female,18-24
14750,12600,2150,37,male,25-39
37550,12600,24950,20,female,18-24
20050,10750,9300,28,female,25-39
21400,10050,11350,29,male,25-39
50500,22900,27600,24,female,18-24
41500,22350,19150,21,female,18-24
8450,9150,-700,18,male,18-24
31500,12600,18900,18,female,18-24
131050,41150,89900,21,male,18-24
40000,14800,25200,24,female,18-24
43850,15500,28350,18,female,18-24
10650,7000,3650,19,male,18-24
8850,7950,900,20,male,18-24
8600,7400,1200,19,male,18-24
13400,7750,5650,18,male,18-24
21950,12350,9600,36,Female,25-39
8600,7700,900,19,male,18-24
23250,13200,10050,26,female,25-39
11150,9100,2050,19,male,18-24
23300,13300,10000,28,male,25-39
11400,8700,2700,18,male,18-24
52800,18650,34150,19,female,18-24
29000,14000,15000,18,female,18-24
28850,15900,12950,18,female,18-24
44700,25450,19250,23,female,18-24
8600,9350,-750,18,male,18-24
10800,8850,1950,18,male,18-24
14150,9750,4400,31,Female,25-39
7600,7450,150,19,male,18-24
10550,8600,1950,18,male,18-24
9450,7950,1500,20,male,18-24
10800,8300,2500,18,male,18-24
43250,13050,30200,19,female,18-24
13900,8500,5400,19,male,18-24
45300,18900,26400,21,female,18-24
36800,17550,19250,18,female,18-24
33300,16200,17100,18,female,18-24
20450,10600,9850,32,male,25-39
13350,9050,4300,18,male,18-24
9500,6700,2800,18,male,18-24
59800,22350,37450,21,female,18-24
44750,22450,22300,18,female,18-24
19200,11800,7400,27,female,25-39
34300,9100,25200,18,female,18-24
49350,18850,30500,19,female,18-24
132450,46350,86100,23,male,18-24
10050,9400,650,18,male,18-24
10200,8250,1950,19,male,18-24
18600,10300,8300,31,male,25-39
31250,11500,19750,18,female,18-24
20800,9400,11400,32,male,25-39
104950,46450,58500,24,male,18-24
23550,11200,12350,32,Female,25-39
18550,13550,5000,36,male,25-39
9700,9650,50,19,male,18-24
124050,38900,85150,24,male,18-24
40400,10400,30000,18,female,18-24
12100,7400,4700,19,male,18-24
13750,6150,7600,18,male,18-24
12100,7400,4700,20,male,18-24
17250,9850,7400,27,female,25-39
46450,14450,32000,18,female,18-24
12050,7650,4400,18,male,18-24
19500,14000,5500,32,Female,25-39
8900,4700,4200,19,male,18-24
8350,7800,550,18,male,18-24
38100,20250,17850,18,female,18-24
8750,6550,2200,18,male,18-24
11650,6200,5450,19,male,18-24
14300,9400,4900,19,male,18-24
23500,13750,9750,30,male,25-39
23300,11300,12000,27,female,25-39
22950,13000,9950,30,FEMALE,25-39
45600,28200,17400,23,female,18-24
11900,8250,3650,18,male,18-24
46900,16350,30550,19,female,18-24
117250,35950,81300,23,male,18-24
20450,14300,6150,29,FEMALE,25-39
11250,7000,4250,18,male,18-24
41700,24350,17350,21,female,18-24
24400,10900,13500,29,FEMALE,25-39
19800,13950,5850,32,male,25-39
10250,6550,3700,18,male,18-24
9750,9150,600,18,male,18-24
35450,15450,20000,18,female,18-24
6800,16600,-9800,36,Female,25-39
21500,13350,8150,32,male,25-39
22800,14550,8250,18,female,18-24
10000,6650,3350,19,male,18-24
12350,8450,3900,18,male,18-24
33950,16700,17250,19,female,18-24
10200,7700,2500,19,male,18-24
44250,14450,29800,18,female,18-24
20400,16000,4400,29,male,25-39
24150,12550,11600,19,female,18-24
128150,44500,83650,21,male,18-24
26000,11950,14050,33,Female,25-39
9950,11400,-1450,34,Female,25-39
18950,15700,3250,36,male,25-39
22050,15700,6350,34,Female,25-39
11050,7950,3100,18,male,18-24
58250,13050,45200,19,female,18-24
8800,8600,200,18,male,18-24
8250,8500,-250,20,male,18-24
10650,8700,1950,18,male,18-24
8850,7650,1200,20,male,18-24
14050,13750,300,29,male,25-39
18950,10900,8050,30,male,25-39
9450,9350,100,20,male,18-24
42200,11350,30850,19,female,18-24
12300,8350,3950,18,male,18-24
7800,7800,0,19,male,18-24
122450,38700,83750,21,male,18-24
11700,9800,1900,18,male,18-24
125450,39650,85800,21,male,18-24
46350,13300,33050,18,female,18-24
37850,20450,17400,18,female,18-24
35700,14750,20950,19,female,18-24
12350,8100,4250,18,male,18-24
20200,11250,8950,27,female,25-39
42450,18150,24300,18,female,18-24
29400,20600,8800,18,female,18-24
9250,7950,1300,18,male,18-24
28850,16800,12050,18,female,18-24
57900,19750,38150,18,female,18-24
24250,9950,14300,37,male,25-39
10550,11600,-1050,40,female,40+
8450,8600,-150,18,male,18-24
59300,21200,38100,21,female,18-24
49050,14300,34750,18,female,18-24
39700,16650,23050,18,female,18-24
11550,9450,2100,18,male,18-24
12200,7400,4800,18,male,18-24
8900,11100,-2200,40,female,40+
55350,19000,36350,18,female,18-24
11400,10350,1050,41,female,40+
25650,11650,14000,29,FEMALE,25-39
39600,19100,20500,19,female,18-24
50150,13150,37000,18,female,18-24
44050,12650,31400,19,female,18-24
8400,7850,550,19,male,18-24
46900,22250,24650,21,female,18-24
12500,7950,4550,19,male,18-24
25000,12600,12400,35,male,25-39
54350,20450,33900,21,female,18-24
8550,7700,850,20,male,18-24
11900,7600,4300,19,male,18-24
24200,11050,13150,32,Female,25-39
7800,8200,-400,19,male,18-24
57650,28200,29450,22,female,18-24
33700,20200,13500,22,female,18-24
8700,9000,-300,19,male,18-24
20650,10450,10200,27,male,25-39
11800,8000,3800,18,male,18-24
9350,6750,2600,18,male,18-24
27750,11900,15850,37,Female,25-39
99900,35050,64850,21,male,18-24
20200,13250,6950,29,FEMALE,25-39
20700,16300,4400,25,male,25-39
41650,16750,24900,18,female,18-24
39300,11450,27850,19,female,18-24
52850,21300,31550,18,female,18-24
20500,10800,9700,28,male,25-39
20800,13200,7600,34,male,25-39
23450,11600,11850,31,Female,25-39
60300,15000,45300,18,female,18-24
8150,8900,-750,18,male,18-24
41700,15800,25900,18,female,18-24
16150,9850,6300,29,FEMALE,25-39
9800,9700,100,18,male,18-24
12150,8900,3250,20,male,18-24
24500,12400,12100,30,male,25-39
8600,7550,1050,18,male,18-24
11100,8400,2700,18,male,18-24
47200,10800,36400,18,female,18-24
11100,13400,-2300,30,male,25-39
9500,7850,1650,18,male,18-24
37050,13950,23100,19,female,18-24
8750,7700,1050,18,male,18-24
7500,7400,100,18,male,18-24
10600,7500,3100,18,male,18-24
14150,7850,6300,18,male,18-24
10100,7450,2650,18,male,18-24
44500,14150,30350,19,female,18-24
48800,16200,32600,18,female,18-24
33700,14000,19700,18,female,18-24
9450,8150,1300,18,male,18-24
40450,19250,21200,19,female,18-24
129650,31900,97750,23,male,18-24
16350,13850,2500,27,male,25-39
112650,40050,72600,21,male,18-24
43300,17650,25650,18,female,18-24
45650,10250,35400,18,female,18-24
20300,11350,8950,28,male,25-39
18200,12950,5250,25,female,25-39
31550,16700,14850,19,female,18-24
12050,11600,450,44,female,40+
41600,14100,27500,18,female,18-24
9250,8700,550,18,male,18-24
10700,6450,4250,19,male,18-24
111150,40600,70550,21,male,18-24
48000,19600,28400,18,female,18-24
17400,9850,7550,26,female,25-39
105250,42750,62500,21,male,18-24
6750,7150,-400,18,male,18-24
42500,19100,23400,18,female,18-24
30950,22150,8800,21,female,18-24
15650,12950,2700,25,male,25-39
26850,14350,12500,38,Female,25-39
11800,6950,4850,19,male,18-24
45900,18250,27650,21,female,18-24
55500,24700,30800,21,female,18-24
36500,12900,23600,19,female,18-24
18600,13600,5000,34,male,25-39
16800,12100,4700,26,female,25-39
24200,12900,11300,32,Female,25-39
15300,12600,2700,34,Female,25-39
16200,12350,3850,34,Female,25-39
8350,9000,-650,18,male,18-24
22400,10300,12100,25,female,25-39
12250,9400,2850,31,male,25-39
8800,9650,-850,27,male,25-39
14250,11600,2650,29,male,25-39
29700,13400,16300,28,FEMALE,25-39
112100,34250,77850,22,male,18-24
29850,6850,23000,19,female,18-24
40650,17100,23550,19,female,18-24
17850,12050,5800,31,male,25-39
15500,12550,2950,25,female,25-39
15850,12750,3100,32,male,25-39
106450,42900,63550,22,male,18-24
9450,9000,450,18,male,18-24
12300,12100,200,27,male,25-39
38050,16900,21150,18,female,18-24
45850,17700,28150,18,female,18-24
55200,12650,42550,18,female,18-24
7800,7650,150,19,male,18-24
18600,10750,7850,26,female,25-39
11700,8200,3500,20,male,18-24
17850,12100,5750,27,female,25-39
16700,7250,9450,29,FEMALE,25-39
50300,21150,29150,18,female,18-24
32300,19900,12400,22,female,18-24
55150,24800,30350,22,female,18-24
20850,14050,6800,30,FEMALE,25-39
10000,7900,2100,18,male,18-24
11600,7950,3650,20,male,18-24
7500,7550,-50,18,male,18-24
13300,9450,3850,18,male,18-24
7600,8650,-1050,19,male,18-24
49250,17200,32050,22,female,18-24
108450,38800,69650,21,male,18-24
41950,9750,32200,18,female,18-24
18300,13400,4900,27,male,25-39
21150,10650,10500,31,male,25-39
24300,10400,13900,32,male,25-39
37000,17250,19750,18,female,18-24
9000,6450,2550,19,male,18-24
10550,7200,3350,18,male,18-24
10400,8750,1650,18,male,18-24
10200,7600,2600,18,male,18-24
12050,6950,5100,19,male,18-24
27800,13550,14250,19,female,18-24
23200,12900,10300,27,female,25-39
8250,9100,-850,18,male,18-24
56800,18450,38350,21,female,18-24
36100,13000,23100,18,female,18-24
11350,8050,3300,19,male,18-24
23950,15050,8900,37,Female,25-39
9400,7400,2000,20,male,18-24
11950,13350,-1400,25,male,25-39
42450,19500,22950,18,female,18-24
15450,7750,7700,18,male,18-24
9550,7200,2350,19,male,18-24
11250,8350,2900,18,male,18-24
6200,8450,-2250,20,male,18-24
10500,9000,1500,18,male,18-24
39250,14250,25000,18,female,18-24
13500,6900,6600,18,male,18-24
52750,16300,36450,19,female,18-24
11800,8900,2900,19,male,18-24
9200,9100,100,20,male,18-24
32600,11600,21000,18,female,18-24
20400,11850,8550,29,male,25-39
62050,17800,44250,21,female,18-24
30600,13000,17600,18,female,18-24
10800,8150,2650,18,male,18-24
10800,6900,3900,19,male,18-24
13700,10350,3350,28,male,25-39
7950,8050,-100,19,male,18-24
44300,16400,27900,18,female,18-24
11100,8150,2950,20,male,18-24
9100,9700,-600,20,male,18-24
40750,14050,26700,19,female,18-24
9800,8800,1000,19,male,18-24
38500,15000,23500,18,female,18-24
56400,16050,40350,19,female,18-24
21300,10000,11300,36,male,25-39
37650,19900,17750,18,female,18-24
109800,36350,73450,21,male,18-24
18900,11750,7150,31,Female,25-39
15050,13100,1950,34,Female,25-39
113650,48800,64850,24,male,18-24
6600,12050,-5450,29,male,25-39
22650,8600,14050,35,Female,25-39
10600,7250,3350,18,male,18-24
9500,9050,450,18,male,18-24
8750,6450,2300,20,male,18-24
11200,6350,4850,18,male,18-24
17850,14750,3100,32,Female,25-39
50950,17550,33400,21,female,18-24
15500,9400,6100,37,male,25-39
37650,14200,23450,18,female,18-24
55150,20550,34600,21,female,18-24
8500,7250,1250,18,male,18-24
40150,13850,26300,18,female,18-24
13800,13600,200,34,Female,25-39
19900,12500,7400,36,Female,25-39
9850,6300,3550,18,male,18-24
12600,7550,5050,20,male,18-24
42950,10800,32150,18,female,18-24
45550,13750,31800,19,female,18-24
19450,12750,6700,35,Female,25-39
10800,9400,1400,18,male,18-24
11650,7750,3900,18,male,18-24
18100,14600,3500,35,male,25-39
13100,7600,5500,19,male,18-24
29400,12400,17000,32,Female,25-39
39150,21650,17500,22,female,18-24
12800,7300,5500,18,male,18-24
29800,17850,11950,18,female,18-24
25600,10900,14700,27,female,25-39
23200,9900,13300,26,male,25-39
94250,42750,51500,21,male,18-24
20350,14000,6350,33,male,25-39
40650,14300,26350,18,female,18-24
41250,13350,27900,19,female,18-24
39700,17800,21900,18,female,18-24
51800,25950,25850,23,female,18-24
49200,21950,27250,21,female,18-24
19300,13250,6050,37,Female,25-39
7950,7300,650,18,male,18-24
42000,12900,29100,19,female,18-24
18900,11750,7150,25,female,25-39
7600,9050,-1450,18,male,18-24
17650,10850,6800,29,FEMALE,25-39
40000,15850,24150,18,female,18-24
40300,25500,14800,22,female,18-24
8250,7900,350,18,male,18-24
33600,17100,16500,19,female,18-24
8600,7900,700,19,male,18-24
10550,9900,650,19,male,18-24
11650,8950,2700,20,male,18-24
19900,14550,5350,35,male,25-39
61800,15700,46100,21,female,18-24
11500,7850,3650,19,male,18-24
5650,6850,-1200,18,male,18-24
16350,10050,6300,30,Female,25-39
42900,14850,28050,18,female,18-24
9150,8050,1100,18,male,18-24
37900,12150,25750,18,female,18-24
17600,10200,7400,31,male,25-39
10850,9100,1750,18,male,18-24
38450,9350,29100,19,female,18-24
46200,21300,24900,21,female,18-24
58400,22400,36000,22,female,18-24
16050,11300,4750,30,male,25-39
27250,15350,11900,20,female,18-24
8600,7800,800,19,male,18-24
47800,18400,29400,18,female,18-24
10150,6200,3950,18,male,18-24
124650,44300,80350,21,male,18-24
16400,8800,7600,18,male,18-24
10150,7500,2650,18,male,18-24
9650,6500,3150,20,male,18-24
9850,7950,1900,19,male,18-24
28200,9500,18700,34,male,25-39
10900,7100,3800,18,male,18-24
38500,22150,16350,24,female,18-24
11850,7850,4000,19,male,18-24
33850,16250,17600,18,female,18-24
13650,8650,5000,18,male,18-24
10450,7900,2550,19,male,18-24
44700,9500,35200,19,female,18-24
22850,12150,10700,29,FEMALE,25-39
21550,11150,10400,30,FEMALE,25-39
126250,48700,77550,21,male,18-24
8800,8050,750,19,male,18-24
16050,13850,2200,31,male,25-39
11450,7950,3500,18,male,18-24
13200,8900,4300,20,male,18-24
10250,7350,2900,18,male,18-24
21300,12500,8800,25,female,25-39
47300,15850,31450,19,female,18-24
41850,16100,25750,18,female,18-24
10000,6750,3250,18,male,18-24
19050,14750,4300,25,male,25-39
9850,8350,1500,18,male,18-24
50100,16600,33500,18,female,18-24
37650,17250,20400,19,female,18-24
12250,9050,3200,18,male,18-24
54500,9450,45050,19,female,18-24
10000,7450,2550,20,male,18-24
15550,11800,3750,36,male,25-39
22600,12550,10050,26,male,25-39
106300,45950,60350,24,male,18-24
44800,18100,26700,21,female,18-24
12200,7650,4550,20,male,18-24
40650,9900,30750,18,female,18-24
11150,8950,2200,18,male,18-24
43650,16300,27350,19,female,18-24
8600,9100,-500,18,male,18-24
13700,8350,5350,18,male,18-24
10700,8500,2200,18,male,18-24
18750,10750,8000,32,Female,25-39
14000,6300,7700,19,male,18-24
35800,10950,24850,18,female,18-24
17500,10950,6550,29,FEMALE,25-39
12600,9400,3200,19,male,18-24
7100,8900,-1800,20,male,18-24
6900,7300,-400,19,male,18-24
24200,13050,11150,19,female,18-24
63300,14700,48600,23,female,18-24
17100,13350,3750,26,female,25-39
37850,14500,23350,18,female,18-24
11600,8950,2650,18,male,18-24
18900,15950,2950,32,male,25-39
8100,8000,100,20,male,18-24
8600,8700,-100,20,male,18-24
42100,16450,25650,22,female,18-24
15850,12700,3150,29,male,25-39
24250,11700,12550,27,female,25-39
33950,15100,18850,18,female,18-24
45650,21200,24450,24,female,18-24
45200,17350,27850,18,female,18-24
44200,14300,29900,19,female,18-24
10600,6650,3950,18,male,18-24
110900,43400,67500,21,male,18-24
24050,10900,13150,34,male,25-39
9750,5850,3900,18,male,18-24
36550,14700,21850,18,female,18-24
18400,7700,10700,34,Female,25-39
43550,14300,29250,19,female,18-24
19500,11400,8100,38,male,25-39
27550,10000,17550,19,female,18-24
29900,18500,11400,18,female,18-24
134450,42850,91600,21,male,18-24
35100,10000,25100,18,female,18-24
49100,10750,38350,18,female,18-24
10600,6400,4200,18,male,18-24
20150,12800,7350,26,female,25-39
8900,7350,1550,20,male,18-24
23000,13850,9150,36,male,25-39
7400,7400,0,20,male,18-24
17050,12150,4900,34,Female,25-39
11700,7600,4100,20,male,18-24
38450,12700,25750,18,female,18-24
9350,7450,1900,19,male,18-24
8700,9450,-750,19,male,18-24
17500,14900,2600,33,male,25-39
43800,20700,23100,21,female,18-24
8200,6600,1600,18,male,18-24
11750,9100,2650,18,male,18-24
22450,13200,9250,34,Female,25-39
11600,8600,3000,20,male,18-24
4300,7550,-3250,18,male,18-24
133350,35450,97900,21,male,18-24
31400,13250,18150,19,female,18-24
9350,8050,1300,20,male,18-24
23450,10800,12650,29,FEMALE,25-39
40600,14100,26500,18,female,18-24
20250,11400,8850,26,male,25-39
12700,7650,5050,18,male,18-24
15950,11650,4300,30,male,25-39
12700,11700,1000,31,male,25-39
50250,13700,36550,19,female,18-24
15800,13250,2550,36,Female,25-39
9600,8350,1250,19,male,18-24
22200,12750,9450,25,female,25-39
5750,7900,-2150,19,male,18-24
8050,8900,-850,19,male,18-24
44550,8900,35650,18,female,18-24
9750,8150,1600,18,male,18-24
10500,7850,2650,20,male,18-24
42850,16200,26650,18,female,18-24
39650,15200,24450,18,female,18-24
25800,9100,16700,19,female,18-24
20150,11100,9050,31,Female,25-39
34800,16000,18800,18,female,18-24
126600,38600,88000,21,male,18-24
17300,12600,4700,31,male,25-39
33600,13750,19850,19,female,18-24
43800,18250,25550,18,female,18-24
113100,38500,74600,23,male,18-24
109700,39150,70550,21,male,18-24
9550,7550,2000,18,male,18-24
11500,11650,-150,45,female,40+
45000,14750,30250,18,female,18-24
44400,10100,34300,20,female,18-24
11650,7000,4650,19,male,18-24
47150,15200,31950,19,female,18-24
44000,14250,29750,18,female,18-24
11400,7300,4100,18,male,18-24
22950,8550,14400,34,male,25-39
41900,18600,23300,22,female,18-24
35850,12050,23800,18,female,18-24
11550,5900,5650,20,male,18-24
11550,6200,5350,18,male,18-24
27300,10850,16450,31,male,25-39
11250,7600,3650,18,male,18-24
14450,7300,7150,18,male,18-24
9600,7000,2600,19,male,18-24
10950,9300,1650,20,male,18-24
8200,8250,-50,18,male,18-24
21400,11950,9450,34,male,25-39
30750,16850,13900,19,female,18-24
8450,9250,-800,18,male,18-24
22200,11350,10850,26,male,25-39
18350,10900,7450,28,FEMALE,25-39
44600,16750,27850,18,female,18-24
36450,17900,18550,19,female,18-24
20200,11300,8900,31,Female,25-39
36900,15200,21700,18,female,18-24
21250,17450,3800,18,female,18-24
10700,7450,3250,18,male,18-24
47400,13050,34350,19,female,18-24
124250,40700,83550,22,male,18-24
17950,9950,8000,29,male,25-39
39800,10750,29050,18,female,18-24
59000,14400,44600,21,female,18-24
12250,8150,4100,18,male,18-24
46650,17800,28850,19,female,18-24
33200,17400,15800,19,female,18-24
42100,15150,26950,18,female,18-24
10300,8500,1800,18,male,18-24
10950,7500,3450,19,male,18-24
54700,25100,29600,21,female,18-24
25350,9150,16200,25,male,25-39
7750,9300,-1550,18,male,18-24
18950,11800,7150,35,male,25-39
15400,14950,450,27,male,25-39
38850,15800,23050,19,female,18-24
16400,15500,900,31,Female,25-39
13600,7250,6350,20,male,18-24
52400,11950,40450,19,female,18-24
14400,11350,3050,26,female,25-39
47650,14850,32800,20,female,18-24
57900,16300,41600,18,female,18-24
10650,8050,2600,20,male,18-24
11500,7300,4200,18,male,18-24
54000,13350,40650,21,female,18-24
14700,8300,6400,18,male,18-24
21950,13700,8250,28,FEMALE,25-39
43500,8350,35150,19,female,18-24
44600,18300,26300,19,female,18-24
8200,7050,1150,18,male,18-24
10550,8250,2300,18,male,18-24
56900,16200,40700,18,female,18-24
6800,8550,-1750,20,male,18-24
8900,9750,-850,20,male,18-24
16150,10700,5450,38,Female,25-39
15100,11000,4100,26,male,25-39
37550,19000,18550,18,female,18-24
20200,13150,7050,35,Female,25-39
43350,19900,23450,18,female,18-24
7200,6150,1050,19,male,18-24
8450,6850,1600,18,male,18-24
45750,23350,22400,24,female,18-24
63900,24950,38950,22,female,18-24
37900,13750,24150,18,female,18-24
10550,7600,2950,20,male,18-24
12400,7700,4700,19,male,18-24
7300,8450,-1150,18,male,18-24
43000,21250,21750,24,female,18-24
42550,26300,16250,21,female,18-24
44750,10150,34600,18,female,18-24
43050,13950,29100,18,female,18-24
19500,13400,6100,31,Female,25-39
10100,10200,-100,18,male,18-24
7700,8600,-900,18,male,18-24
55850,14000,41850,18,female,18-24
9800,9650,150,20,male,18-24
16350,7450,8900,33,male,25-39
9900,8500,1400,18,male,18-24
15200,10750,4450,30,male,25-39
8700,8900,-200,18,male,18-24
21500,9800,11700,29,male,25-39
11700,8350,3350,20,male,18-24
54250,20700,33550,22,female,18-24
122450,39050,83400,21,male,18-24
21900,13700,8200,26,male,25-39
16100,12650,3450,31,male,25-39
10500,7600,2900,18,male,18-24
33350,14100,19250,18,female,18-24
17100,13450,3650,39,male,25-39
10750,8600,2150,18,male,18-24
101400,43900,57500,23,male,18-24
41400,22050,19350,21,female,18-24
18100,12500,5600,29,FEMALE,25-39
10150,9450,700,18,male,18-24
17200,12400,4800,26,female,25-39
26150,10150,16000,26,female,25-39
34950,15000,19950,18,female,18-24
35250,22700,12550,18,female,18-24
20050,11900,8150,26,male,25-39
8250,7600,650,19,male,18-24
9600,11050,-1450,40,female,40+
123450,40400,83050,23,male,18-24
122100,42250,79850,23,male,18-24
18800,11350,7450,28,FEMALE,25-39
10750,7800,2950,20,male,18-24
9400,6850,2550,20,male,18-24
11650,9150,2500,20,male,18-24
6650,8050,-1400,20,male,18-24
30150,15450,14700,18,female,18-24
32400,15550,16850,19,female,18-24
8050,7600,450,19,male,18-24
28600,15650,12950,18,female,18-24
10250,8150,2100,19,male,18-24
11850,7750,4100,19,male,18-24
8500,6300,2200,19,male,18-24
34700,13750,20950,18,female,18-24
114400,38800,75600,21,male,18-24
37300,13150,24150,18,female,18-24
118200,37300,80900,23,male,18-24
6850,8000,-1150,20,male,18-24
9800,8600,1200,18,male,18-24
19150,13550,5600,34,male,25-39
8600,7650,950,20,male,18-24
12450,8650,3800,18,male,18-24
38400,16150,22250,19,female,18-24
12150,8500,3650,19,male,18-24
6850,10650,-3800,19,male,18-24
10500,7800,2700,19,male,18-24
14600,9150,5450,25,male,25-39
21650,9550,12100,36,male,25-39
42100,17600,24500,18,female,18-24
32900,18600,14300,19,female,18-24
10850,7400,3450,18,male,18-24
42950,9450,33500,19,female,18-24
15050,14550,500,31,Female,25-39
17150,13200,3950,31,Female,25-39
22350,13800,8550,28,FEMALE,25-39
7750,5850,1900,19,male,18-24
35800,11700,24100,20,female,18-24
24050,14100,9950,34,male,25-39
19000,12150,6850,25,female,25-39
10400,8350,2050,19,male,18-24
9250,7450,1800,18,male,18-24
7100,7350,-250,19,male,18-24
115450,40050,75400,21,male,18-24
47150,9500,37650,18,female,18-24
47900,17300,30600,21,female,18-24
34150,9550,24600,18,female,18-24
21050,11750,9300,31,Female,25-39
10750,9950,800,18,male,18-24
44200,15300,28900,19,female,18-24
31100,16900,14200,19,female,18-24
14800,7750,7050,19,male,18-24
8800,7050,1750,19,male,18-24
13350,12200,1150,37,Female,25-39
7700,7250,450,18,male,18-24
124250,43600,80650,21,male,18-24
23050,14800,8250,34,male,25-39
16450,11900,4550,28,FEMALE,25-39
7250,7700,-450,18,male,18-24
10500,6550,3950,18,male,18-24
9800,8400,1400,18,male,18-24
6400,8350,-1950,19,male,18-24
20950,13450,7500,34,male,25-39
22750,11750,11000,35,Female,25-39
6900,7700,-800,18,male,18-24
52100,16450,35650,18,female,18-24
40350,13450,26900,23,female,18-24
17250,11500,5750,37,Female,25-39
46300,24750,21550,21,female,18-24
133000,46250,86750,21,male,18-24
27000,10800,16200,32,Female,25-39
12300,11250,1050,40,female,40+
21000,11100,9900,33,Female,25-39
30850,10150,20700,37,male,25-39
12200,7250,4950,20,male,18-24
48950,20450,28500,22,female,18-24
12950,8650,4300,20,male,18-24
9400,7400,2000,20,male,18-24
119000,46800,72200,21,male,18-24
27650,8150,19500,19,female,18-24
53100,16550,36550,21,female,18-24
25150,7900,17250,30,male,25-39
12150,7150,5000,19,male,18-24
26000,7750,18250,25,female,25-39
51400,11250,40150,18,female,18-24
21700,12150,9550,26,female,25-39
36900,11100,25800,18,female,18-24
18750,13450,5300,31,male,25-39
20700,13650,7050,34,Female,25-39
8050,7600,450,18,male,18-24
55050,12850,42200,18,female,18-24
7650,7750,-100,18,male,18-24
10400,9150,1250,20,male,18-24
48400,16900,31500,18,female,18-24
19900,13700,6200,26,female,25-39
14700,8200,6500,19,male,18-24
12300,10550,1750,33,male,25-39
38700,7800,30900,19,female,18-24
9850,7000,2850,18,male,18-24
8550,9550,-1000,18,male,18-24
42700,14000,28700,18,female,18-24
34050,16250,17800,18,female,18-24
10350,6950,3400,18,male,18-24
12700,7950,4750,18,male,18-24
5100,8600,-3500,19,male,18-24
24700,11200,13500,27,female,25-39
24550,8200,16350,26,female,25-39
8800,8350,450,19,male,18-24
8750,7550,1200,18,male,18-24
26900,16850,10050,18,female,18-24
8950,7100,1850,19,male,18-24
55250,20750,34500,24,female,18-24
28250,15200,13050,19,female,18-24
7550,6950,600,19,male,18-24
21150,12800,8350,27,male,25-39
21050,11100,9950,31,Female,25-39
43000,13700,29300,18,female,18-24
8250,5250,3000,18,male,18-24
8250,7400,850,19,male,18-24
7550,8050,-500,18,male,18-24
9650,7450,2200,20,male,18-24
45550,11950,33600,19,female,18-24
130650,33100,97550,24,male,18-24
13900,10900,3000,34,male,25-39
43900,13750,30150,19,female,18-24
12050,8300,3750,19,male,18-24
11200,11850,-650,40,female,40+
7450,7250,200,18,male,18-24
8800,9200,-400,19,male,18-24
12050,12250,-200,41,female,40+
18100,8400,9700,34,male,25-39
7150,9050,-1900,18,male,18-24
25650,20400,5250,18,female,18-24
21300,13050,8250,26,female,25-39
129750,37650,92100,22,male,18-24
8850,7250,1600,18,male,18-24
22750,13550,9200,29,FEMALE,25-39
51650,21300,30350,21,female,18-24
46800,17000,29800,22,female,18-24
46000,24750,21250,21,female,18-24
12700,8100,4600,19,male,18-24
114700,40250,74450,21,male,18-24
17350,13200,4150,29,FEMALE,25-39
10750,8200,2550,20,male,18-24
12450,9500,2950,18,male,18-24
45200,19400,25800,24,female,18-24
122750,34750,88000,22,male,18-24
29950,12800,17150,19,female,18-24
49650,20900,28750,22,female,18-24
19400,10650,8750,38,Female,25-39
13500,8050,5450,18,male,18-24
10300,10200,100,40,male,40+
19700,11250,8450,32,Female,25-39
22300,9150,13150,28,male,25-39
15200,13150,2050,33,Female,25-39
20500,13400,7100,32,male,25-39
47350,22100,25250,21,female,18-24
8850,7350,1500,19,male,18-24
55100,17450,37650,24,female,18-24
11450,7850,3600,18,male,18-24
9750,6200,3550,19,male,18-24
41200,15800,25400,18,female,18-24
19700,13200,6500,26,female,25-39
9850,7900,1950,18,male,18-24
123850,35300,88550,23,male,18-24
49400,19000,30400,18,female,18-24
29150,10900,18250,18,female,18-24
46100,13450,32650,18,female,18-24
52800,17800,35000,18,female,18-24
8450,7150,1300,19,male,18-24
40650,18900,21750,19,female,18-24
52900,13850,39050,18,female,18-24
13200,7150,6050,19,male,18-24
61400,10700,50700,19,female,18-24
16300,12200,4100,36,Female,25-39
8500,9300,-800,20,male,18-24
16800,14800,2000,29,male,25-39
9000,9350,-350,19,male,18-24
9150,8000,1150,20,male,18-24
41350,20350,21000,22,female,18-24
18750,14100,4650,26,male,25-39
44700,16300,28400,18,female,18-24
5700,7000,-1300,19,male,18-24
12100,6550,5550,18,male,18-24
24050,10000,14050,38,male,25-39
55150,16100,39050,18,female,18-24
17900,15650,2250,26,male,25-39
41200,18900,22300,18,female,18-24
9300,7600,1700,19,male,18-24
39650,15000,24650,18,female,18-24
31550,10000,21550,18,female,18-24
7300,9650,-2350,18,male,18-24
9950,7500,2450,18,male,18-24
12700,7700,5000,18,male,18-24
7450,7700,-250,18,male,18-24
7900,7250,650,19,male,18-24
8500,9100,-600,18,male,18-24
58150,26950,31200,23,female,18-24
126600,42750,83850,22,male,18-24
46300,13950,32350,18,female,18-24
5950,8650,-2700,20,male,18-24
117250,37200,80050,22,male,18-24
49050,17600,31450,22,female,18-24
9550,5950,3600,20,male,18-24
17750,12650,5100,36,Female,25-39
33100,15800,17300,19,female,18-24
10250,6050,4200,19,male,18-24
40900,17350,23550,22,female,18-24
42300,18000,24300,19,female,18-24
13650,8600,5050,19,male,18-24
40600,11600,29000,19,female,18-24
34750,10150,24600,18,female,18-24
30700,13050,17650,18,female,18-24
8500,7500,1000,19,male,18-24
14000,10450,3550,19,male,18-24
7350,8900,-1550,18,male,18-24
44700,13200,31500,18,female,18-24
37100,12400,24700,18,female,18-24
131900,36550,95350,21,male,18-24
21900,15050,6850,27,male,25-39
10600,8900,1700,19,male,18-24
14000,12250,1750,38,male,25-39
36600,14950,21650,19,female,18-24
114550,38400,76150,21,male,18-24
18000,11950,6050,34,Female,25-39
10100,9150,950,19,male,18-24
13150,7700,5450,18,male,18-24
10000,11250,-1250,41,female,40+
11000,9000,2000,18,male,18-24
9600,7850,1750,18,male,18-24
33300,18300,15000,19,female,18-24
47250,14050,33200,19,female,18-24
12150,8250,3900,18,male,18-24
9600,6900,2700,19,male,18-24
11600,6750,4850,18,male,18-24
8950,12200,-3250,27,female,25-39
10150,14600,-4450,34,Female,25-39
3750,10000,-6250,18,male,18-24
11050,9450,1600,18,male,18-24
42200,11300,30900,18,female,18-24
25100,10350,14750,32,Female,25-39
10800,9700,1100,18,male,18-24
44800,9900,34900,19,female,18-24
24900,8850,16050,36,Female,25-39
47600,16750,30850,18,female,18-24
43000,17650,25350,18,female,18-24
36550,17000,19550,18,female,18-24
111950,39050,72900,22,male,18-24
21750,12200,9550,25,female,25-39
12550,8000,4550,18,male,18-24
7150,8600,-1450,19,male,18-24
8950,8200,750,18,male,18-24
39300,20350,18950,18,female,18-24
15300,7600,7700,19,male,18-24
11850,7050,4800,18,male,18-24
9550,7000,2550,18,male,18-24
20500,10100,10400,27,female,25-39
6400,6150,250,19,male,18-24
38300,11950,26350,19,female,18-24
37600,17000,20600,18,female,18-24
20800,12650,8150,31,male,25-39
7350,9150,-1800,20,male,18-24
14650,12800,1850,25,male,25-39
21000,9450,11550,30,male,25-39
46150,23300,22850,21,female,18-24
22950,11500,11450,33,male,25-39
56950,20400,36550,22,female,18-24
28650,10300,18350,36,Female,25-39
44200,16350,27850,20,female,18-24
51450,22100,29350,21,female,18-24
8900,9750,-850,18,male,18-24
8500,6050,2450,20,male,18-24
11550,6150,5400,18,male,18-24
113800,44700,69100,21,male,18-24
15700,12100,3600,31,male,25-39
14200,6450,7750,18,male,18-24
51800,13250,38550,18,female,18-24
10200,7350,2850,18,male,18-24
21350,12000,9350,37,male,25-39
54550,17350,37200,18,female,18-24
24700,11200,13500,29,male,25-39
24250,12600,11650,38,male,25-39
47450,11800,35650,19,female,18-24
15650,14450,1200,26,male,25-39
6600,6700,-100,18,male,18-24
10250,7650,2600,18,male,18-24
41300,14800,26500,18,female,18-24
22700,10450,12250,26,male,25-39
8450,7350,1100,20,male,18-24
22600,16700,5900,25,male,25-39
10950,6700,4250,18,male,18-24
46500,23550,22950,21,female,18-24
113900,35550,78350,23,male,18-24
51000,11100,39900,18,female,18-24
50550,16850,33700,18,female,18-24
9500,7650,1850,19,male,18-24
10800,9150,1650,19,male,18-24
9100,6950,2150,18,male,18-24
39300,15250,24050,19,female,18-24
110750,43600,67150,21,male,18-24
6650,9850,-3200,18,male,18-24
14300,6250,8050,19,male,18-24
104900,39100,65800,21,male,18-24
10900,7800,3100,19,male,18-24
25300,8800,16500,26,female,25-39
42400,17300,25100,19,female,18-24
43550,19600,23950,18,female,18-24
25900,11450,14450,26,female,25-39
9550,9300,250,18,male,18-24
118100,40650,77450,24,male,18-24
10350,7850,2500,18,male,18-24
8500,8650,-150,18,male,18-24
8700,8250,450,19,male,18-24
7850,7950,-100,20,male,18-24
9250,7300,1950,18,male,18-24
8250,8550,-300,19,male,18-24
10650,8000,2650,18,male,18-24
12250,8450,3800,19,male,18-24
11600,10100,1500,19,male,18-24
120250,35150,85100,21,male,18-24
7700,8800,-1100,18,male,18-24
8650,7150,1500,18,male,18-24
40900,12250,28650,18,female,18-24
31850,13100,18750,19,female,18-24
10600,7750,2850,20,male,18-24
23950,11550,12400,39,Female,25-39
43600,20800,22800,21,female,18-24
8500,6900,1600,20,male,18-24
19000,11350,7650,30,FEMALE,25-39
10250,7950,2300,18,male,18-24
52700,17650,35050,19,female,18-24
40450,15000,25450,18,female,18-24
31050,16150,14900,18,female,18-24
23250,10700,12550,34,male,25-39
23150,18100,5050,18,female,18-24
9300,7450,1850,18,male,18-24
10750,8750,2000,19,male,18-24
12750,8000,4750,18,male,18-24
9950,6750,3200,20,male,18-24
45750,12400,33350,18,female,18-24
20300,13850,6450,38,male,25-39
112350,42200,70150,23,male,18-24
12700,8900,3800,19,male,18-24
29750,12600,17150,19,female,18-24
25300,12700,12600,25,female,25-39
44500,18900,25600,19,female,18-24
20450,13400,7050,26,male,25-39
7850,7550,300,18,male,18-24
36500,19200,17300,18,female,18-24
6700,6800,-100,18,male,18-24
19000,9950,9050,28,FEMALE,25-39
19900,9850,10050,27,male,25-39
15250,9350,5900,33,Female,25-39
118550,40750,77800,22,male,18-24
11850,7950,3900,18,male,18-24
23300,6750,16550,28,male,25-39
43850,17850,26000,19,female,18-24
18300,11900,6400,30,Female,25-39
25600,10950,14650,27,female,25-39
48850,15300,33550,18,female,18-24
50200,7000,43200,20,female,18-24
10550,9300,1250,19,male,18-24
21700,15650,6050,27,male,25-39
9900,6350,3550,18,male,18-24
19350,13350,6000,28,FEMALE,25-39
13100,13700,-600,26,male,25-39
24600,14200,10400,26,male,25-39
8750,7050,1700,20,male,18-24
8200,7350,850,19,male,18-24
22350,14350,8000,36,male,25-39
12300,7650,4650,18,male,18-24
49800,15250,34550,21,female,18-24
46500,20100,26400,18,female,18-24
8600,7750,850,19,male,18-24
11550,9300,2250,18,male,18-24
44850,13450,31400,18,female,18-24
8350,8200,150,20,male,18-24
7800,7500,300,18,male,18-24
13000,7300,5700,19,male,18-24
19600,9300,10300,36,Female,25-39
18050,12700,5350,25,male,25-39
11300,7300,4000,19,male,18-24
42300,15200,27100,18,female,18-24
6750,9250,-2500,18,male,18-24
6150,8550,-2400,19,male,18-24
109600,41800,67800,21,male,18-24
12000,15300,-3300,25,female,25-39
21800,13250,8550,25,female,25-39
47850,19250,28600,19,female,18-24
49950,9400,40550,18,female,18-24
14950,8300,6650,19,male,18-24
4750,6300,-1550,18,male,18-24
7750,7850,-100,18,male,18-24
42350,15800,26550,19,female,18-24
9200,7800,1400,20,male,18-24
10250,11550,-1300,43,female,40+
48100,15500,32600,19,female,18-24
131650,39850,91800,22,male,18-24
9550,7650,1900,18,male,18-24
20700,11250,9450,31,Female,25-39
40200,13500,26700,19,female,18-24
35050,21000,14050,21,female,18-24
63850,19300,44550,24,female,18-24
10350,8500,1850,19,male,18-24
52650,19100,33550,21,female,18-24
42200,15250,26950,19,female,18-24
12950,10000,2950,19,male,18-24
11450,6850,4600,18,male,18-24
16450,16550,-100,34,Female,25-39
33700,15850,17850,18,female,18-24
44800,16050,28750,19,female,18-24
12500,8050,4450,18,male,18-24
22300,12600,9700,34,Female,25-39
11350,14650,-3300,31,Female,25-39
44300,19000,25300,18,female,18-24
41550,17150,24400,18,female,18-24
19750,9100,10650,25,female,25-39
19800,11400,8400,28,male,25-39
17800,12500,5300,27,male,25-39
9900,9500,400,20,male,18-24
55500,17900,37600,18,female,18-24
8550,7950,600,20,male,18-24
8150,7750,400,19,male,18-24
37700,12200,25500,18,female,18-24
16900,11350,5550,31,Female,25-39
10750,7450,3300,19,male,18-24
8600,9000,-400,20,male,18-24
9700,7600,2100,18,male,18-24
38750,15750,23000,18,female,18-24
41050,22850,18200,21,female,18-24
17500,12500,5000,27,female,25-39
11050,9050,2000,18,male,18-24
110350,41050,69300,21,male,18-24
16150,6200,9950,18,male,18-24
48100,9650,38450,18,female,18-24
9350,7050,2300,18,male,18-24
17900,11900,6000,33,male,25-39
19300,12750,6550,32,Female,25-39
8100,8550,-450,18,male,18-24
10150,10550,-400,32,male,25-39
12200,7000,5200,18,male,18-24
9100,12650,-3550,40,female,40+
8850,10200,-1350,18,male,18-24
8350,9750,-1400,18,male,18-24
43300,20800,22500,23,female,18-24
10900,7050,3850,18,male,18-24
10800,7350,3450,18,male,18-24
39500,18600,20900,18,female,18-24
37300,17100,20200,18,female,18-24
41300,14450,26850,18,female,18-24
10300,9150,1150,20,male,18-24
18950,13850,5100,18,female,18-24
47000,12500,34500,18,female,18-24
14050,8350,5700,26,male,25-39
45300,13750,31550,18,female,18-24
18400,11100,7300,35,male,25-39
11750,8550,3200,18,male,18-24
7800,7700,100,18,male,18-24
9500,7750,1750,18,male,18-24
11500,8300,3200,20,male,18-24
9950,9800,150,18,male,18-24
10400,6150,4250,18,male,18-24
13750,9000,4750,18,male,18-24
48250,5950,42300,19,female,18-24
11150,7250,3900,18,male,18-24
17300,12850,4450,26,male,25-39
10750,6350,4400,18,male,18-24
26750,13950,12800,25,male,25-39
41000,25750,15250,21,female,18-24
8850,7600,1250,18,male,18-24
58350,22200,36150,22,female,18-24
5350,7650,-2300,20,male,18-24
4550,7800,-3250,18,male,18-24
10750,8400,2350,18,male,18-24
13950,12550,1400,27,male,25-39
12300,7800,4500,19,male,18-24
58950,32700,26250,22,female,18-24
22150,11900,10250,26,female,25-39
33550,18500,15050,19,female,18-24
18600,11950,6650,34,Female,25-39
114350,39050,75300,24,male,18-24
118150,41900,76250,24,male,18-24
42050,11700,30350,19,female,18-24
14500,11950,2550,26,female,25-39
8600,8050,550,19,male,18-24
39900,27200,12700,21,female,18-24
20650,12050,8600,32,male,25-39
15200,13800,1400,33,Female,25-39
15200,8750,6450,38,male,25-39
9300,7550,1750,19,male,18-24
5850,8300,-2450,20,male,18-24
22450,11100,11350,31,Female,25-39
32150,15350,16800,19,female,18-24
42100,16750,25350,18,female,18-24
22800,12200,10600,29,male,25-39
17050,13550,3500,29,FEMALE,25-39
20800,12550,8250,33,male,25-39
12300,7600,4700,20,male,18-24
121700,43450,78250,24,male,18-24
113550,40550,73000,22,male,18-24
11600,9650,1950,18,male,18-24
5800,9150,-3350,18,male,18-24
38450,14800,23650,19,female,18-24
53900,22350,31550,22,female,18-24
27250,10400,16850,29,FEMALE,25-39
10500,10250,250,30,male,25-39
14400,8100,6300,18,male,18-24
13300,7750,5550,19,male,18-24
18450,13350,5100,31,Female,25-39
9800,7000,2800,18,male,18-24
12200,7850,4350,20,male,18-24
21800,13650,8150,35,Female,25-39
55450,21850,33600,21,female,18-24
104850,40850,64000,22,male,18-24
8850,7250,1600,18,male,18-24
23300,12300,11000,26,female,25-39
22200,12450,9750,36,male,25-39
12150,10350,1800,18,male,18-24
27450,9350,18100,29,FEMALE,25-39
44350,10600,33750,19,female,18-24
37250,17850,19400,18,female,18-24
10750,6300,4450,20,male,18-24
37050,14050,23000,19,female,18-24
8650,10200,-1550,19,male,18-24
9300,7550,1750,20,male,18-24
18300,9650,8650,26,male,25-39
38600,12900,25700,18,female,18-24
9050,7550,1500,18,male,18-24
115950,42400,73550,21,male,18-24
26300,10700,15600,32,male,25-39
18950,11100,7850,29,male,25-39
43600,21250,22350,18,female,18-24
46300,16300,30000,18,female,18-24
43900,19150,24750,21,female,18-24
11100,6400,4700,20,male,18-24
10550,7300,3250,18,male,18-24
14900,8650,6250,18,male,18-24
11800,6200,5600,18,male,18-24
24650,9600,15050,32,Female,25-39
5000,10050,-5050,18,male,18-24
11200,7000,4200,18,male,18-24
11300,8700,2600,18,male,18-24
50950,15200,35750,18,female,18-24
44250,14250,30000,18,female,18-24
108700,33600,75100,21,male,18-24
10800,9100,1700,18,male,18-24
6900,8300,-1400,19,male,18-24
49650,18150,31500,22,female,18-24
11350,8250,3100,40,female,40+
21500,15550,5950,29,male,25-39
46850,15700,31150,18,female,18-24
54800,22450,32350,22,female,18-24
25250,11200,14050,26,female,25-39
19550,7700,11850,32,male,25-39
55300,20750,34550,21,female,18-24
134200,42450,91750,22,male,18-24
40200,14450,25750,18,female,18-24
16150,8050,8100,27,female,25-39
10800,7950,2850,19,male,18-24
37800,16350,21450,18,female,18-24
16100,13500,2600,31,Female,25-39
10550,6900,3650,18,male,18-24
49500,11550,37950,18,female,18-24
42950,18750,24200,18,female,18-24
20100,14900,5200,27,female,25-39
32750,22700,10050,22,female,18-24
57600,15150,42450,23,female,18-24
50100,13450,36650,19,female,18-24
39200,20050,19150,18,female,18-24
19400,10300,9100,29,male,25-39
35900,15550,20350,18,female,18-24
24100,11800,12300,38,male,25-39
9650,7800,1850,18,male,18-24
48200,10650,37550,18,female,18-24
11400,8100,3300,19,male,18-24
8600,8300,300,18,male,18-24
15800,12400,3400,33,male,25-39
23850,12800,11050,31,male,25-39
12700,6800,5900,18,male,18-24
32350,16750,15600,18,female,18-24
9550,6300,3250,20,male,18-24
32550,18650,13900,19,female,18-24
11350,9700,1650,18,male,18-24
20450,14400,6050,27,male,25-39
15700,12450,3250,29,male,25-39
21550,9900,11650,29,FEMALE,25-39
10750,9200,1550,18,male,18-24
12050,8000,4050,20,male,18-24
11100,7800,3300,19,male,18-24
17550,10850,6700,32,male,25-39
11450,7200,4250,18,male,18-24
43400,19350,24050,18,female,18-24
8850,7450,1400,18,male,18-24
10400,7400,3000,18,male,18-24
5900,7800,-1900,19,male,18-24
13450,8700,4750,20,male,18-24
6700,7500,-800,18,male,18-24
24200,11900,12300,27,female,25-39
43800,17250,26550,18,female,18-24
49350,8900,40450,19,female,18-24
116600,41900,74700,21,male,18-24
21450,12950,8500,27,male,25-39
12550,5800,6750,18,male,18-24
51100,17250,33850,21,female,18-24
19900,13050,6850,26,male,25-39
45500,15350,30150,23,female,18-24
50700,18950,31750,18,female,18-24
43200,18750,24450,18,female,18-24
18750,13500,5250,32,male,25-39
33750,9200,24550,18,female,18-24
11950,8900,3050,19,male,18-24
106850,39850,67000,22,male,18-24
45250,23500,21750,19,female,18-24
24400,14350,10050,35,male,25-39
26850,13750,13100,30,male,25-39
113650,43450,70200,21,male,18-24
10000,7350,2650,18,male,18-24
17450,9200,8250,25,female,25-39
44500,9700,34800,20,female,18-24
9400,8250,1150,19,male,18-24
51150,15150,36000,18,female,18-24
20600,12400,8200,32,Female,25-39
9600,8350,1250,18,male,18-24
43650,22200,21450,21,female,18-24
33450,11750,21700,18,female,18-24
47950,16450,31500,22,female,18-24
10500,8550,1950,18,male,18-24
16050,11900,4150,32,male,25-39
10200,6450,3750,20,male,18-24
18250,13000,5250,30,FEMALE,25-39
11050,8550,2500,18,male,18-24
50900,15450,35450,18,female,18-24
8400,8550,-150,18,male,18-24
10050,6450,3600,19,male,18-24
12900,8700,4200,18,male,18-24
34350,19700,14650,18,female,18-24
19750,9150,10600,37,Female,25-39
9600,6150,3450,18,male,18-24
112650,45250,67400,23,male,18-24
24750,15150,9600,36,male,25-39
40050,13300,26750,18,female,18-24
9300,9550,-250,19,male,18-24
6500,8550,-2050,20,male,18-24
46100,13350,32750,19,female,18-24
5450,7950,-2500,18,male,18-24
50700,22400,28300,22,female,18-24
10700,10600,100,20,male,18-24
54050,20150,33900,22,female,18-24
38950,18000,20950,18,female,18-24
47250,14750,32500,18,female,18-24
9350,7750,1600,19,male,18-24
14050,14550,-500,28,male,25-39
16950,13850,3100,37,male,25-39
15450,14700,750,30,male,25-39
125050,38000,87050,22,male,18-24
11400,7850,3550,19,male,18-24
18100,15750,2350,25,female,25-39
57550,23100,34450,22,female,18-24
15650,11250,4400,25,male,25-39
13500,6850,6650,19,male,18-24
25600,16050,9550,18,female,18-24
23700,15200,8500,28,FEMALE,25-39
43900,15000,28900,18,female,18-24
6550,8300,-1750,20,male,18-24
40550,16950,23600,18,female,18-24
17650,9550,8100,29,FEMALE,25-39
8900,9500,-600,18,male,18-24
57450,18950,38500,21,female,18-24
17550,15300,2250,36,Female,25-39
8300,8250,50,20,male,18-24
19750,12000,7750,34,Female,25-39
5850,6200,-350,19,male,18-24
105000,47050,57950,21,male,18-24
11600,8200,3400,18,male,18-24
49100,16950,32150,18,female,18-24
20800,8900,11900,36,Female,25-39
18600,11300,7300,31,Female,25-39
13300,8650,4650,19,male,18-24
16100,12300,3800,29,FEMALE,25-39
8450,7000,1450,19,male,18-24
7750,8450,-700,18,male,18-24
14850,9950,4900,29,FEMALE,25-39
22000,13100,8900,31,Female,25-39
48300,17900,30400,18,female,18-24
13000,13400,-400,25,male,25-39
8600,8950,-350,18,male,18-24
22750,10050,12700,33,Female,25-39
8550,6600,1950,18,male,18-24
21100,12800,8300,30,FEMALE,25-39
51950,16300,35650,21,female,18-24
12300,8900,3400,20,male,18-24
24100,13300,10800,27,male,25-39
47250,12600,34650,21,female,18-24
4950,8050,-3100,20,male,18-24
10550,7600,2950,18,male,18-24
127750,45100,82650,22,male,18-24
11550,6750,4800,18,male,18-24
9450,8100,1350,19,male,18-24
24500,12400,12100,29,FEMALE,25-39
8850,7100,1750,18,male,18-24
22400,14900,7500,35,male,25-39
9850,10050,-200,20,male,18-24
11150,7600,3550,19,male,18-24
9250,9250,0,19,male,18-24
21500,13950,7550,30,FEMALE,25-39
35300,13100,22200,18,female,18-24
22900,10700,12200,35,Female,25-39
40800,14850,25950,18,female,18-24
28600,17750,10850,19,female,18-24
37800,9900,27900,18,female,18-24
22650,9550,13100,25,male,25-39
28950,14750,14200,18,female,18-24
43650,13900,29750,18,female,18-24
45050,16200,28850,19,female,18-24
10700,8650,2050,18,male,18-24
10150,6200,3950,18,male,18-24
5350,8300,-2950,18,male,18-24
51250,18600,32650,21,female,18-24
10550,6100,4450,20,male,18-24
35550,20600,14950,18,female,18-24
6350,6950,-600,18,male,18-24
7500,6400,1100,19,male,18-24
120100,37500,82600,21,male,18-24
36100,16400,19700,18,female,18-24
49250,13800,35450,19,female,18-24
24150,13100,11050,26,male,25-39
50800,24150,26650,21,female,18-24
17450,10300,7150,29,FEMALE,25-39
34800,11900,22900,18,female,18-24
61050,17350,43700,22,female,18-24
22950,9600,13350,27,female,25-39
34300,20500,13800,18,female,18-24
8100,7850,250,19,male,18-24
18800,13550,5250,28,female,25-39
8500,8600,-100,18,male,18-24
11750,8850,2900,20,male,18-24
11850,10200,1650,19,male,18-24
25150,17150,8000,18,female,18-24
32500,16300,16200,18,female,18-24
24000,14100,9900,25,male,25-39
8700,7700,1000,18,male,18-24
9000,7050,1950,18,male,18-24
25450,13150,12300,27,female,25-39
8050,10000,-1950,19,male,18-24
31100,18700,12400,19,female,18-24
29750,14300,15450,18,female,18-24
17600,13350,4250,26,male,25-39
11450,9700,1750,20,male,18-24
7900,6950,950,18,male,18-24
7900,9600,-1700,18,male,18-24
10450,8300,2150,20,male,18-24
57100,11500,45600,19,female,18-24
24300,7850,16450,30,FEMALE,25-39
46700,21250,25450,21,female,18-24
13500,9000,4500,18,male,18-24
55050,26500,28550,24,female,18-24
20900,12350,8550,32,Female,25-39
25750,12200,13550,28,male,25-39
46300,15500,30800,18,female,18-24
42900,12600,30300,23,female,18-24
10300,7200,3100,20,male,18-24
18900,14500,4400,28,female,25-39
40650,12750,27900,19,female,18-24
21850,11850,10000,19,female,18-24
47600,25750,21850,22,female,18-24
7850,10000,-2150,20,male,18-24
30400,11650,18750,26,female,25-39
8650,8450,200,18,male,18-24
48450,19850,28600,18,female,18-24
14350,13850,500,35,Female,25-39
7300,8150,-850,20,male,18-24
11200,9600,1600,18,male,18-24
40150,17050,23100,24,female,18-24
8950,7900,1050,19,male,18-24
12450,8550,3900,18,male,18-24
31300,16850,14450,18,female,18-24
10400,8000,2400,20,male,18-24
21200,13250,7950,30,male,25-39
31900,13850,18050,18,female,18-24
9500,12400,-2900,41,female,40+
42250,23450,18800,21,female,18-24
49600,22400,27200,18,female,18-24
9800,9500,300,20,male,18-24
14300,8150,6150,18,male,18-24
12250,10600,1650,25,female,25-39
23950,8100,15850,35,Female,25-39
52200,19700,32500,21,female,18-24
21850,10000,11850,28,male,25-39
14350,11350,3000,28,female,25-39
121100,42800,78300,24,male,18-24
58300,17050,41250,22,female,18-24
59200,14800,44400,18,female,18-24
52600,24500,28100,22,female,18-24
11250,7950,3300,19,male,18-24
58650,20300,38350,23,female,18-24
23350,11900,11450,36,male,25-39
107650,42200,65450,22,male,18-24
22400,15150,7250,31,male,25-39
50800,18400,32400,21,female,18-24
21800,12800,9000,26,male,25-39
9850,7350,2500,18,male,18-24
23000,14850,8150,38,Female,25-39
18700,13550,5150,31,Female,25-39
109050,32700,76350,21,male,18-24
41900,16200,25700,18,female,18-24
13300,7550,5750,18,male,18-24
7550,9150,-1600,20,male,18-24
19100,7500,11600,35,Female,25-39
12850,7800,5050,18,male,18-24
9450,6500,2950,18,male,18-24
50050,14850,35200,18,female,18-24
23800,11700,12100,34,male,25-39
40950,12200,28750,18,female,18-24
7800,7100,700,20,male,18-24
12350,7550,4800,18,male,18-24
6550,9650,-3100,19,male,18-24
11500,5900,5600,18,male,18-24
32500,15750,16750,18,female,18-24
13900,10850,3050,28,male,25-39
6900,8650,-1750,20,male,18-24
8250,7700,550,18,male,18-24
135750,47700,88050,24,male,18-24
40550,10650,29900,19,female,18-24
58200,18000,40200,18,female,18-24
7200,8750,-1550,18,male,18-24
11050,10700,350,18,male,18-24
8450,6100,2350,19,male,18-24
55300,21500,33800,21,female,18-24
31750,17300,14450,18,female,18-24
9750,8150,1600,19,male,18-24
56150,21050,35100,24,female,18-24
47750,13650,34100,19,female,18-24
19300,11200,8100,27,male,25-39
10350,6750,3600,18,male,18-24
38500,12350,26150,19,female,18-24
35000,9250,25750,18,female,18-24
21950,11600,10350,33,Female,25-39
39800,15700,24100,18,female,18-24
23550,14400,9150,25,female,25-39
46850,26750,20100,21,female,18-24
24550,12550,12000,26,female,25-39
9750,8850,900,18,male,18-24
11500,7950,3550,20,male,18-24
8550,9900,-1350,19,male,18-24
127450,42450,85000,21,male,18-24
113700,46250,67450,23,male,18-24
59800,17500,42300,19,female,18-24
9250,6550,2700,20,male,18-24
122300,41750,80550,21,male,18-24
8100,8700,-600,18,male,18-24
16900,9600,7300,25,female,25-39
49400,15050,34350,19,female,18-24
8500,8850,-350,18,male,18-24
43550,18700,24850,19,female,18-24
10050,9600,450,19,male,18-24
121650,38000,83650,23,male,18-24
10850,10700,150,46,female,40+
12100,9000,3100,20,male,18-24
12350,10550,1800,41,female,40+
53650,16400,37250,18,female,18-24
51100,22000,29100,22,female,18-24
15700,13450,2250,30,male,25-39
37150,13650,23500,19,female,18-24
34600,13200,21400,18,female,18-24
8700,9350,-650,45,male,40+
9900,9300,600,20,male,18-24
8250,8450,-200,18,male,18-24
37700,22050,15650,19,female,18-24
17950,11300,6650,27,female,25-39
20700,9350,11350,27,female,25-39
45600,14750,30850,18,female,18-24
9400,7500,1900,18,male,18-24
11950,6150,5800,19,male,18-24
19300,13000,6300,29,male,25-39
19050,11500,7550,30,male,25-39
10100,9400,700,20,male,18-24
32050,14700,17350,18,female,18-24
11250,8350,2900,19,male,18-24
5350,6200,-850,18,male,18-24
13400,9800,3600,19,male,18-24
20350,13350,7000,28,male,25-39
8300,7100,1200,18,male,18-24
57400,11900,45500,18,female,18-24
26550,13250,13300,37,Female,25-39
10050,7450,2600,19,male,18-24
55150,22700,32450,24,female,18-24
53350,21950,31400,24,female,18-24
118650,37550,81100,21,male,18-24
23650,10000,13650,18,female,18-24
24900,8700,16200,27,female,25-39
21950,10100,11850,39,Female,25-39
42200,16650,25550,18,female,18-24
18800,12150,6650,31,male,25-39
119700,33200,86500,23,male,18-24
39550,15350,24200,21,female,18-24
22050,12400,9650,28,male,25-39
16200,9850,6350,33,male,25-39
7450,8200,-750,20,male,18-24
45950,14350,31600,19,female,18-24
128700,40100,88600,21,male,18-24
34650,17850,16800,18,female,18-24
22200,13650,8550,32,male,25-39
53150,17000,36150,19,female,18-24
9200,6250,2950,20,male,18-24
11600,9400,2200,18,male,18-24
16650,15300,1350,25,female,25-39
49250,18050,31200,21,female,18-24
23200,14750,8450,33,male,25-39
37450,17700,19750,18,female,18-24
11600,9100,2500,20,male,18-24
22850,11350,11500,25,female,25-39
13450,8100,5350,18,male,18-24
104050,40350,63700,22,male,18-24
25300,16000,9300,19,female,18-24
9600,8400,1200,20,male,18-24
9850,9150,700,18,male,18-24
53050,22600,30450,21,female,18-24
8850,8350,500,18,male,18-24
21250,8700,12550,25,male,25-39
20250,9750,10500,29,male,25-39
16050,12500,3550,37,male,25-39
42200,16200,26000,18,female,18-24
8600,7500,1100,18,male,18-24
99700,40050,59650,21,male,18-24
9550,6550,3000,19,male,18-24
10450,8650,1800,18,male,18-24
14950,13250,1700,31,male,25-39
64900,17900,47000,23,female,18-24
37850,16450,21400,18,female,18-24
36650,18050,18600,18,female,18-24
33600,18050,15550,19,female,18-24
12100,6400,5700,18,male,18-24
40600,21000,19600,20,female,18-24
41600,18750,22850,18,female,18-24
47400,14200,33200,18,female,18-24
62100,20000,42100,21,female,18-24
49650,20800,28850,23,female,18-24
20100,13150,6950,31,male,25-39
113150,36050,77100,23,male,18-24
10600,8500,2100,18,male,18-24
12850,9100,3750,19,male,18-24
16100,10800,5300,27,female,25-39
29650,18000,11650,18,female,18-24
50350,14150,36200,22,female,18-24
64000,14800,49200,19,female,18-24
17000,11850,5150,35,Female,25-39
40100,13850,26250,19,female,18-24
32050,12250,19800,19,female,18-24
14050,7450,6600,18,male,18-24
30250,15200,15050,19,female,18-24
142100,41350,100750,21,male,18-24
18400,12150,6250,38,male,25-39
38900,16700,22200,18,female,18-24
52950,22750,30200,18,female,18-24
52800,18650,34150,18,female,18-24
11400,7550,3850,19,male,18-24
14850,14850,0,34,male,25-39
9450,6300,3150,20,male,18-24
8500,9800,-1300,19,male,18-24
40500,18800,21700,19,female,18-24
13200,8250,4950,18,male,18-24
27250,17700,9550,19,female,18-24
24450,15550,8900,33,Female,25-39
44600,15150,29450,18,female,18-24
11450,7100,4350,20,male,18-24
18050,9950,8100,35,Female,25-39
21600,10350,11250,27,female,25-39
53950,14000,39950,18,female,18-24
14600,7550,7050,20,male,18-24
106600,40450,66150,21,male,18-24
66200,18100,48100,21,female,18-24
4950,8050,-3100,19,male,18-24
9700,8150,1550,18,male,18-24
16800,16300,500,32,male,25-39
20600,14500,6100,25,female,25-39
54100,21050,33050,21,female,18-24
30650,16100,14550,18,female,18-24
45350,10750,34600,19,female,18-24
10300,7900,2400,18,male,18-24
19750,9850,9900,28,FEMALE,25-39
57100,21400,35700,22,female,18-24
26950,13750,13200,28,FEMALE,25-39
5550,9200,-3650,18,male,18-24
9800,8500,1300,19,male,18-24
48400,26000,22400,22,female,18-24
10900,9250,1650,20,male,18-24
54650,16800,37850,22,female,18-24
13400,8300,5100,18,male,18-24
9400,5400,4000,18,male,18-24
26500,15200,11300,25,female,25-39
20200,14900,5300,30,FEMALE,25-39
21600,12750,8850,26,female,25-39
11600,7000,4600,19,male,18-24
12350,6050,6300,18,male,18-24
46900,16550,30350,18,female,18-24
11450,7850,3600,18,male,18-24
43350,17600,25750,19,female,18-24
15950,5400,10550,26,female,25-39
9850,7450,2400,18,male,18-24
36150,14850,21300,22,female,18-24
24200,13750,10450,31,male,25-39
23250,10300,12950,27,female,25-39
33350,9900,23450,19,female,18-24
117400,37150,80250,22,male,18-24
21000,14050,6950,34,Female,25-39
18550,10850,7700,27,female,25-39
16650,12750,3900,30,FEMALE,25-39
54500,15150,39350,24,female,18-24
19600,10350,9250,28,male,25-39
30150,9900,20250,18,female,18-24
10700,9850,850,18,male,18-24
10100,9150,950,20,male,18-24
139800,40200,99600,21,male,18-24
23100,12750,10350,25,female,25-39
11900,8000,3900,18,male,18-24
7100,8500,-1400,18,male,18-24
14250,14200,50,25,female,25-39
37950,23950,14000,21,female,18-24
47700,18500,29200,18,female,18-24
8000,8200,-200,19,male,18-24
7650,7400,250,18,male,18-24
49050,15000,34050,18,female,18-24
10250,7650,2600,20,male,18-24
18550,8550,10000,30,Female,25-39
52600,22400,30200,24,female,18-24
11850,7250,4600,19,male,18-24
12500,5700,6800,19,male,18-24
19700,13400,6300,26,male,25-39
46850,17500,29350,18,female,18-24
9700,11600,-1900,40,female,40+
12000,7200,4800,18,male,18-24
18850,13100,5750,34,Female,25-39
12200,12200,0,35,male,25-39
39600,15200,24400,18,female,18-24
53000,15950,37050,18,female,18-24
119300,41350,77950,21,male,18-24
47600,17700,29900,19,female,18-24
8650,8450,200,20,male,18-24
45000,12400,32600,20,female,18-24
44150,21250,22900,22,female,18-24
19750,10700,9050,39,male,25-39
43750,20500,23250,18,female,18-24
10200,9750,450,18,male,18-24
32000,13650,18350,18,female,18-24
9000,7750,1250,18,male,18-24
16650,11900,4750,37,male,25-39
9600,8250,1350,19,male,18-24
10850,8500,2350,20,male,18-24
8700,9550,-850,19,male,18-24
63150,25750,37400,21,female,18-24
60200,14700,45500,18,female,18-24
45700,26500,19200,23,female,18-24
11000,6750,4250,19,male,18-24
9850,8950,900,18,male,18-24
7450,6950,500,18,male,18-24
15350,11950,3400,34,Female,25-39
24300,11550,12750,26,female,25-39
41050,16200,24850,20,female,18-24
11000,7000,4000,20,male,18-24
23000,10550,12450,28,FEMALE,25-39
36750,12650,24100,19,female,18-24
107000,42050,64950,21,male,18-24
14350,13000,1350,25,female,25-39
25100,10750,14350,26,male,25-39
40650,16150,24500,18,female,18-24
8100,7600,500,18,male,18-24
15400,13900,1500,18,female,18-24
25800,9300,16500,26,male,25-39
10700,8850,1850,19,male,18-24
9200,8500,700,19,male,18-24
128500,39150,89350,22,male,18-24
11050,6700,4350,18,male,18-24
8900,8450,450,18,male,18-24
38650,12650,26000,18,female,18-24
110450,34500,75950,21,male,18-24
41400,19300,22100,24,female,18-24
48500,22700,25800,21,female,18-24
10600,6400,4200,19,male,18-24
33000,14100,18900,18,female,18-24
13500,6950,6550,19,male,18-24
101250,39900,61350,22,male,18-24
7650,9450,-1800,20,male,18-24
45700,14600,31100,18,female,18-24
9400,9150,250,18,male,18-24
123450,45800,77650,21,male,18-24
11600,10350,1250,18,male,18-24
41000,20350,20650,21,female,18-24
7950,6750,1200,19,male,18-24
40100,10950,29150,19,female,18-24
13900,14000,-100,25,male,25-39
17600,15050,2550,35,male,25-39
49200,17300,31900,21,female,18-24
29500,20900,8600,21,female,18-24
128500,44300,84200,21,male,18-24
40300,18100,22200,20,female,18-24
44600,12950,31650,18,female,18-24
13150,8000,5150,18,male,18-24
9800,8350,1450,18,male,18-24
42250,13050,29200,19,female,18-24
12850,7250,5600,18,male,18-24
8700,7400,1300,18,male,18-24
10400,9100,1300,18,male,18-24
8500,8400,100,19,male,18-24
43200,15800,27400,24,female,18-24
5200,6950,-1750,18,male,18-24
8050,6650,1400,18,male,18-24
13300,7400,5900,20,male,18-24
8900,7950,950,19,male,18-24
53400,14900,38500,19,female,18-24
51150,20150,31000,22,female,18-24
16700,9250,7450,26,male,25-39
10850,8050,2800,18,male,18-24
22150,22550,-400,18,female,18-24
28550,12350,16200,35,Female,25-39
9100,7700,1400,20,male,18-24
10850,6900,3950,19,male,18-24
25700,13300,12400,27,female,25-39
36050,17600,18450,19,female,18-24
19850,12250,7600,33,Female,25-39
9950,9700,250,40,male,40+
141500,37800,103700,21,male,18-24
8300,7750,550,18,male,18-24
28700,20350,8350,18,female,18-24
50550,24450,26100,21,female,18-24
56250,19500,36750,21,female,18-24
9550,7700,1850,18,male,18-24
9400,9000,400,19,male,18-24
9250,9300,-50,19,male,18-24
27650,15850,11800,19,female,18-24
34450,10200,24250,18,female,18-24
121700,47250,74450,24,male,18-24
32650,10500,22150,18,female,18-24
47400,17100,30300,21,female,18-24
42200,18900,23300,21,female,18-24
9150,8850,300,19,male,18-24
55900,20850,35050,18,female,18-24
18250,14800,3450,27,female,25-39
10350,10000,350,19,male,18-24
6650,9700,-3050,20,male,18-24
8000,7300,700,19,male,18-24
135000,40950,94050,23,male,18-24
25450,10250,15200,25,male,25-39
11450,7600,3850,18,male,18-24
9450,7700,1750,19,male,18-24
6900,8350,-1450,19,male,18-24
15350,12550,2800,33,male,25-39
131650,42200,89450,21,male,18-24
10100,7700,2400,18,male,18-24
39150,15800,23350,19,female,18-24
6550,8150,-1600,18,male,18-24
9900,7350,2550,18,male,18-24
12550,13100,-550,27,male,25-39
18550,10050,8500,25,male,25-39
14500,7700,6800,19,male,18-24
5450,6300,-850,19,male,18-24
37750,16250,21500,18,female,18-24
11050,7600,3450,19,male,18-24
49450,16200,33250,19,female,18-24
143400,39500,103900,22,male,18-24
10850,7550,3300,18,male,18-24
12250,7100,5150,18,male,18-24
8750,9100,-350,19,male,18-24
30050,11000,19050,28,male,25-39
8650,8150,500,19,male,18-24
21650,10900,10750,31,Female,25-39
41200,14300,26900,18,female,18-24
20700,13550,7150,34,Female,25-39
6300,6450,-150,20,male,18-24
130700,34600,96100,23,male,18-24
22600,10450,12150,31,male,25-39
48000,17100,30900,18,female,18-24
20900,14250,6650,26,male,25-39
10550,9100,1450,18,male,18-24
39350,17450,21900,19,female,18-24
26450,12100,14350,27,female,25-39
130000,40200,89800,24,male,18-24
38050,9500,28550,19,female,18-24
9150,9600,-450,20,male,18-24
10850,10900,-50,41,female,40+
62300,17750,44550,22,female,18-24
11400,6150,5250,18,male,18-24
126200,34500,91700,22,male,18-24
18500,10650,7850,35,male,25-39
12000,8550,3450,19,male,18-24
16400,12400,4000,39,male,25-39
24300,14850,9450,28,FEMALE,25-39
11550,9300,2250,20,male,18-24
15100,8100,7000,35,male,25-39
11500,7750,3750,18,male,18-24
26350,12500,13850,19,female,18-24
37200,12200,25000,19,female,18-24
19400,14500,4900,26,female,25-39
7550,9050,-1500,20,male,18-24
17650,11150,6500,27,female,25-39
22700,12200,10500,36,Female,25-39
13400,12700,700,34,male,25-39
43350,15550,27800,18,female,18-24
45850,11700,34150,18,female,18-24
13500,8700,4800,19,male,18-24
46600,17000,29600,19,female,18-24
18350,8800,9550,38,Female,25-39
8400,8800,-400,19,male,18-24
18950,12950,6000,33,Female,25-39
23750,10150,13600,32,male,25-39
37600,14150,23450,18,female,18-24
139850,40650,99200,23,male,18-24
45800,8700,37100,18,female,18-24
21800,11450,10350,26,male,25-39
35700,17600,18100,18,female,18-24
9800,7250,2550,20,male,18-24
20650,10400,10250,29,male,25-39
21800,16400,5400,26,male,25-39
55800,17050,38750,21,female,18-24
35800,15000,20800,18,female,18-24
9600,11450,-1850,30,male,25-39
29850,12900,16950,19,female,18-24
9350,8700,650,18,male,18-24
22550,9300,13250,29,FEMALE,25-39
12850,8500,4350,20,male,18-24
45700,13600,32100,18,female,18-24
40000,13100,26900,18,female,18-24
31700,13750,17950,19,female,18-24
9800,10500,-700,41,female,40+
23350,15000,8350,26,male,25-39
35600,17000,18600,18,female,18-24
16850,11750,5100,27,female,25-39
14300,10500,3800,25,female,25-39
40150,17750,22400,19,female,18-24
13800,12400,1400,26,female,25-39
6000,8500,-2500,20,male,18-24
7500,8200,-700,18,male,18-24
16100,16150,-50,34,male,25-39
10450,8450,2000,18,male,18-24
101000,39950,61050,23,male,18-24
9800,6600,3200,18,male,18-24
28100,12750,15350,33,Female,25-39
38650,13650,25000,19,female,18-24
38050,18850,19200,19,female,18-24
32900,8700,24200,18,female,18-24
11250,9300,1950,19,male,18-24
44200,25150,19050,21,female,18-24
14550,7750,6800,20,male,18-24
6450,7650,-1200,18,male,18-24
30300,18550,11750,22,female,18-24
128150,40050,88100,21,male,18-24
24950,17100,7850,35,male,25-39
46150,16500,29650,21,female,18-24
9300,5150,4150,18,male,18-24
53700,17850,35850,24,female,18-24
36550,15450,21100,18,female,18-24
13750,8400,5350,19,male,18-24
24950,14700,10250,34,Female,25-39
60200,18450,41750,23,female,18-24
11600,7400,4200,18,male,18-24
12350,11050,1300,34,male,25-39
40150,13850,26300,18,female,18-24
8650,6000,2650,19,male,18-24
116950,44900,72050,22,male,18-24
35800,18200,17600,18,female,18-24
10200,9650,550,19,male,18-24
12150,6800,5350,18,male,18-24
10750,8550,2200,19,male,18-24
41600,12950,28650,19,female,18-24
63000,20400,42600,22,female,18-24
29900,13350,16550,32,Female,25-39
10400,8200,2200,19,male,18-24
51700,15650,36050,19,female,18-24
15700,10250,5450,29,male,25-39
6400,7000,-600,18,male,18-24
18250,15400,2850,27,female,25-39
37950,17850,20100,18,female,18-24
47150,11800,35350,19,female,18-24
8250,8400,-150,18,male,18-24
40650,10750,29900,18,female,18-24
17200,9400,7800,39,Female,25-39
24550,12600,11950,26,female,25-39
11300,7200,4100,18,male,18-24
25250,10950,14300,36,Female,25-39
39450,11450,28000,18,female,18-24
50100,15650,34450,18,female,18-24
60100,20950,39150,22,female,18-24
19350,11350,8000,36,Female,25-39
64950,24550,40400,22,female,18-24
8600,5600,3000,20,male,18-24
11150,9900,1250,19,male,18-24
9700,8450,1250,19,male,18-24
9400,8650,750,18,male,18-24
18300,14550,3750,27,male,25-39
57100,14700,42400,22,female,18-24
48250,16750,31500,19,female,18-24
24700,16100,8600,29,FEMALE,25-39
10550,9950,600,18,male,18-24
28250,13500,14750,18,female,18-24
8000,7700,300,18,male,18-24
33200,19750,13450,21,female,18-24
26700,13900,12800,19,female,18-24
62950,29400,33550,24,female,18-24
8750,9300,-550,19,male,18-24
41750,15400,26350,18,female,18-24
128450,38500,89950,21,male,18-24
13750,9300,4450,18,male,18-24
10000,8000,2000,20,male,18-24
10350,6500,3850,18,male,18-24
28900,15150,13750,18,female,18-24
10750,7900,2850,19,male,18-24
35300,11850,23450,18,female,18-24
31000,17150,13850,18,female,18-24
110750,38950,71800,21,male,18-24
10850,6300,4550,18,male,18-24
37900,8850,29050,18,female,18-24
34000,14700,19300,18,female,18-24
129400,46800,82600,21,male,18-24
47100,14400,32700,18,female,18-24
34000,10400,23600,19,female,18-24
21850,14200,7650,28,male,25-39
18350,13750,4600,35,male,25-39
121350,38450,82900,21,male,18-24
42100,12050,30050,18,female,18-24
32400,14900,17500,18,female,18-24
8550,9050,-500,18,male,18-24
49150,16400,32750,18,female,18-24
50500,11500,39000,18,female,18-24
27750,13450,14300,30,FEMALE,25-39
48900,22150,26750,22,female,18-24
11450,8550,2900,18,male,18-24
7950,9200,-1250,19,male,18-24
10500,7950,2550,18,male,18-24
21650,10550,11100,32,male,25-39
6450,7750,-1300,20,male,18-24
10100,7400,2700,18,male,18-24
19150,11900,7250,33,Female,25-39
10250,6750,3500,18,male,18-24
15850,15250,600,32,male,25-39
8650,7350,1300,18,male,18-24
9900,7200,2700,18,male,18-24
27400,12850,14550,18,female,18-24
26100,12700,13400,31,Female,25-39
21500,9950,11550,39,male,25-39
10050,8950,1100,19,male,18-24
10400,7850,2550,20,male,18-24
5850,9300,-3450,18,male,18-24
9450,8800,650,18,male,18-24
11400,8650,2750,20,male,18-24
13100,13900,-800,30,FEMALE,25-39
19550,15750,3800,19,female,18-24
43600,16450,27150,18,female,18-24
11650,8400,3250,19,male,18-24
9100,6800,2300,20,male,18-24
35000,13900,21100,18,female,18-24
33650,18200,15450,18,female,18-24
7650,7400,250,18,male,18-24
21450,11250,10200,33,Female,25-39
9150,7300,1850,19,male,18-24
44450,19500,24950,24,female,18-24
8350,6950,1400,18,male,18-24
130650,32700,97950,22,male,18-24
38700,13050,25650,19,female,18-24
36650,13600,23050,18,female,18-24
27600,9750,17850,18,female,18-24
21250,10700,10550,33,male,25-39
29350,8000,21350,29,male,25-39
17850,10550,7300,28,male,25-39
23500,16050,7450,29,FEMALE,25-39
21450,13800,7650,27,male,25-39
11050,6850,4200,18,male,18-24
8600,9050,-450,18,male,18-24
10050,8100,1950,18,male,18-24
132150,44200,87950,21,male,18-24
16650,15500,1150,33,Female,25-39
25950,11500,14450,31,male,25-39
8900,8600,300,20,male,18-24
48600,10650,37950,19,female,18-24
39650,21150,18500,19,female,18-24
33000,13400,19600,18,female,18-24
9250,10700,-1450,20,male,18-24
42500,13750,28750,19,female,18-24
35550,16600,18950,18,female,18-24
10150,8500,1650,19,male,18-24
44050,15850,28200,19,female,18-24
11250,7850,3400,18,male,18-24
10050,8750,1300,18,male,18-24
123200,32550,90650,21,male,18-24
39450,12000,27450,18,female,18-24
10500,7950,2550,18,male,18-24
50700,23400,27300,24,female,18-24
11850,9000,2850,20,male,18-24
8750,8350,400,18,male,18-24
10750,9150,1600,18,male,18-24
40900,18350,22550,18,female,18-24
11400,7850,3550,19,male,18-24
31250,10500,20750,19,female,18-24
21400,9450,11950,28,female,25-39
127300,41100,86200,23,male,18-24
50500,14900,35600,18,female,18-24
23450,9200,14250,35,male,25-39
116000,35600,80400,21,male,18-24
10450,10450,0,20,male,18-24
127400,34050,93350,23,male,18-24
15150,6250,8900,18,male,18-24
22900,13000,9900,37,male,25-39
12350,10350,2000,18,male,18-24
8500,8150,350,20,male,18-24
24900,15950,8950,25,male,25-39
6700,8000,-1300,18,male,18-24
48900,16800,32100,18,female,18-24
9250,8250,1000,19,male,18-24
17800,10650,7150,32,Female,25-39
7950,9350,-1400,20,male,18-24
24350,10850,13500,26,male,25-39
44550,22350,22200,22,female,18-24
46650,18850,27800,19,female,18-24
18000,11850,6150,26,male,25-39
128600,38750,89850,21,male,18-24
16800,13100,3700,31,Female,25-39
129750,39100,90650,22,male,18-24
11650,8750,2900,19,male,18-24
8750,7850,900,19,male,18-24
99850,39750,60100,21,male,18-24
13600,11300,2300,18,male,18-24
11100,12300,-1200,44,female,40+
19400,13800,5600,35,Female,25-39
48850,16400,32450,18,female,18-24
112350,47500,64850,21,male,18-24
23150,13250,9900,33,male,25-39
15500,11300,4200,28,male,25-39
11650,9500,2150,19,male,18-24
12800,8150,4650,18,male,18-24
35400,10000,25400,19,female,18-24
11100,7450,3650,18,male,18-24
124300,41750,82550,21,male,18-24
39750,18700,21050,18,female,18-24
9750,10300,-550,27,female,25-39
19050,11550,7500,25,female,25-39
11900,8450,3450,18,male,18-24
18050,9850,8200,26,female,25-39
46450,15700,30750,19,female,18-24
7100,6650,450,19,male,18-24
18400,12850,5550,34,Female,25-39
136950,33900,103050,21,male,18-24
42750,15400,27350,18,female,18-24
12350,6700,5650,18,male,18-24
14100,9600,4500,31,Female,25-39
9700,8850,850,19,male,18-24
7700,9350,-1650,19,male,18-24
34150,17700,16450,18,female,18-24
8000,8600,-600,20,male,18-24
29200,14950,14250,18,female,18-24
8350,8850,-500,18,male,18-24
45550,10700,34850,19,female,18-24
24300,12750,11550,30,male,25-39
38350,9100,29250,18,female,18-24
11700,7100,4600,19,male,18-24
8650,7150,1500,18,male,18-24
108950,40700,68250,23,male,18-24
14100,14900,-800,30,FEMALE,25-39
7050,5000,2050,18,male,18-24
12500,7850,4650,18,male,18-24
10100,5650,4450,18,male,18-24
35950,13150,22800,19,female,18-24
24150,8800,15350,25,male,25-39
48750,13450,35300,24,female,18-24
53350,25900,27450,21,female,18-24
10800,6400,4400,19,male,18-24
26050,14750,11300,30,FEMALE,25-39
122050,41400,80650,21,male,18-24
8000,6950,1050,20,male,18-24
41650,11400,30250,19,female,18-24
117350,44250,73100,21,male,18-24
12350,9300,3050,18,male,18-24
10050,9050,1000,20,male,18-24
20100,12700,7400,28,female,25-39
23450,15300,8150,19,female,18-24
33350,13750,19600,19,female,18-24
13400,5950,7450,18,male,18-24
18850,9950,8900,32,male,25-39
10150,8750,1400,18,male,18-24
21900,14100,7800,31,male,25-39
10250,9600,650,20,male,18-24
11850,7750,4100,18,male,18-24
10650,6800,3850,19,male,18-24
18000,9300,8700,32,Female,25-39
16200,10400,5800,26,male,25-39
17450,14950,2500,30,male,25-39
8700,7650,1050,18,male,18-24
9050,7150,1900,18,male,18-24
27750,15000,12750,18,female,18-24
21750,10750,11000,35,male,25-39
55900,16500,39400,22,female,18-24
47050,16050,31000,21,female,18-24
8800,5650,3150,19,male,18-24
11150,7800,3350,18,male,18-24
10700,7850,2850,20,male,18-24
18050,12400,5650,28,male,25-39
38000,14350,23650,18,female,18-24
113250,43000,70250,22,male,18-24
9650,6000,3650,19,male,18-24
18450,12500,5950,31,male,25-39
9000,8300,700,19,male,18-24
19450,11200,8250,31,male,25-39
9700,7800,1900,19,male,18-24
8600,7800,800,18,male,18-24
47300,21300,26000,18,female,18-24
42300,9450,32850,18,female,18-24
9950,7600,2350,18,male,18-24
19550,14650,4900,28,female,25-39
44350,9750,34600,24,female,18-24
26950,10850,16100,31,Female,25-39
13800,8100,5700,19,male,18-24
32150,17650,14500,18,female,18-24
40200,17500,22700,19,female,18-24
9850,7050,2800,18,male,18-24
15800,9550,6250,18,male,18-24
38650,18900,19750,24,female,18-24
109850,36250,73600,22,male,18-24
17300,15250,2050,28,male,25-39
19100,11400,7700,25,female,25-39
45150,12200,32950,18,female,18-24
27800,21550,6250,22,female,18-24
18100,13550,4550,30,FEMALE,25-39
17450,8500,8950,29,FEMALE,25-39
39450,18000,21450,18,female,18-24
36200,21500,14700,21,female,18-24
34900,15800,19100,18,female,18-24
42150,18900,23250,22,female,18-24
32750,11300,21450,22,female,18-24
8000,6800,1200,20,male,18-24
55200,15550,39650,18,female,18-24
9400,7700,1700,19,male,18-24
9600,8150,1450,19,male,18-24
15250,11700,3550,35,Female,25-39
12450,6900,5550,20,male,18-24
10200,8050,2150,20,male,18-24
25550,13500,12050,39,male,25-39
9200,7100,2100,19,male,18-24
20400,11950,8450,30,FEMALE,25-39
20500,12950,7550,33,male,25-39
47150,17350,29800,18,female,18-24
9850,9600,250,19,male,18-24
15100,12250,2850,27,male,25-39
48950,13850,35100,18,female,18-24
127350,44450,82900,21,male,18-24
8600,7500,1100,19,male,18-24
11700,8500,3200,19,male,18-24
8500,9500,-1000,20,male,18-24
14750,11200,3550,36,Female,25-39
9850,7850,2000,19,male,18-24
51250,13400,37850,18,female,18-24
11050,7200,3850,20,male,18-24
127100,38200,88900,21,male,18-24
34700,11600,23100,18,female,18-24
38000,15750,22250,19,female,18-24
9700,7850,1850,19,male,18-24
11850,9050,2800,20,male,18-24
10850,5900,4950,19,male,18-24
11750,5700,6050,18,male,18-24
4750,8000,-3250,19,male,18-24
8500,8950,-450,20,male,18-24
13450,7400,6050,18,male,18-24
59550,17150,42400,21,female,18-24
14500,16000,-1500,25,male,25-39
10700,8150,2550,19,male,18-24
11600,6700,4900,20,male,18-24
11600,6950,4650,18,male,18-24
35600,14800,20800,19,female,18-24
46250,24000,22250,21,female,18-24
19550,12450,7100,31,male,25-39
4250,8350,-4100,20,male,18-24
30300,13550,16750,18,female,18-24
22150,9350,12800,34,male,25-39
9850,8950,900,18,male,18-24
35150,16300,18850,18,female,18-24
42250,12100,30150,19,female,18-24
10600,8200,2400,18,male,18-24
40550,10800,29750,18,female,18-24
25200,11150,14050,35,male,25-39
9300,8450,850,20,male,18-24
10750,6900,3850,18,male,18-24
25700,13750,11950,39,male,25-39
10600,7350,3250,19,male,18-24
5550,7750,-2200,18,male,18-24
25350,12250,13100,18,female,18-24
18200,14400,3800,31,male,25-39
19050,11550,7500,35,Female,25-39
28100,12350,15750,25,female,25-39
9550,8100,1450,19,male,18-24
15750,16200,-450,28,female,25-39
16250,13100,3150,26,female,25-39
36450,16650,19800,18,female,18-24
13500,9050,4450,19,male,18-24
16350,7600,8750,32,male,25-39
26150,8850,17300,28,FEMALE,25-39
10600,9100,1500,18,male,18-24
11400,8550,2850,41,female,40+
48450,15850,32600,18,female,18-24
45150,12450,32700,18,female,18-24
19000,12900,6100,26,male,25-39
31600,12850,18750,18,female,18-24
12550,8850,3700,20,male,18-24
25000,9650,15350,29,male,25-39
45950,10050,35900,18,female,18-24
40800,15500,25300,19,female,18-24
111400,37800,73600,24,male,18-24
13050,6250,6800,19,male,18-24
17950,10250,7700,32,male,25-39
7000,8000,-1000,19,male,18-24
38300,23900,14400,21,female,18-24
129750,44950,84800,24,male,18-24
46050,16750,29300,22,female,18-24
10400,9050,1350,18,male,18-24
10100,8650,1450,18,male,18-24
19850,14150,5700,27,male,25-39
18750,10500,8250,35,Female,25-39
38500,26350,12150,22,female,18-24
41250,13250,28000,20,female,18-24
26700,9500,17200,29,FEMALE,25-39
11500,12350,-850,29,male,25-39
9500,8350,1150,18,male,18-24
7850,7950,-100,18,male,18-24
19050,7200,11850,34,Female,25-39
43950,17600,26350,18,female,18-24
14050,11450,2600,33,male,25-39
11450,8650,2800,19,male,18-24
12150,7150,5000,18,male,18-24
10550,6900,3650,18,male,18-24
9900,8750,1150,18,male,18-24
44350,16150,28200,19,female,18-24
35650,22700,12950,22,female,18-24
36450,15550,20900,18,female,18-24
17850,16700,1150,29,FEMALE,25-39
41150,12050,29100,18,female,18-24
12950,8500,4450,19,male,18-24
17100,10600,6500,27,female,25-39
24300,9900,14400,35,Female,25-39
122200,34200,88000,23,male,18-24
21600,11850,9750,32,Female,25-39
9050,8650,400,19,male,18-24
14400,10450,3950,29,FEMALE,25-39
9400,8700,700,18,male,18-24
41900,17250,24650,19,female,18-24
54200,15150,39050,19,female,18-24
9200,7700,1500,18,male,18-24
6850,7550,-700,20,male,18-24
123050,42900,80150,22,male,18-24
40750,23100,17650,21,female,18-24
8050,7500,550,18,male,18-24
10250,6700,3550,18,male,18-24
4450,8600,-4150,18,male,18-24
11100,8250,2850,18,male,18-24
42900,14550,28350,21,female,18-24
8650,8850,-200,18,male,18-24
8250,7400,850,19,male,18-24
18900,11650,7250,34,male,25-39
12350,5550,6800,18,male,18-24
38650,16900,21750,18,female,18-24
15450,12800,2650,29,FEMALE,25-39
11550,8900,2650,19,male,18-24
11500,8200,3300,18,male,18-24
8550,7250,1300,18,male,18-24
12600,8400,4200,18,male,18-24
11650,5700,5950,18,male,18-24
116850,35250,81600,21,male,18-24
10700,8000,2700,18,male,18-24
20600,10100,10500,32,Female,25-39
11250,10050,1200,18,male,18-24
12900,7200,5700,19,male,18-24
20800,11000,9800,33,male,25-39
114650,38850,75800,21,male,18-24
52300,11950,40350,19,female,18-24
23800,12200,11600,26,male,25-39
29700,13800,15900,19,female,18-24
20100,15250,4850,38,Female,25-39
9900,6700,3200,18,male,18-24
40250,14150,26100,19,female,18-24
9750,7300,2450,19,male,18-24
7750,6150,1600,18,male,18-24
17100,10900,6200,28,female,25-39
11150,7650,3500,18,male,18-24
14300,8600,5700,18,male,18-24
32350,15100,17250,19,female,18-24
24850,11550,13300,28,FEMALE,25-39
32550,15750,16800,18,female,18-24
12450,6850,5600,19,male,18-24
8900,8150,750,18,male,18-24
27950,14000,13950,19,female,18-24
9950,8150,1800,19,male,18-24
33000,6600,26400,18,female,18-24
21000,12550,8450,33,male,25-39
9750,9500,250,18,male,18-24
11100,7900,3200,18,male,18-24
26800,11350,15450,31,Female,25-39
12200,4550,7650,18,male,18-24
52250,20450,31800,19,female,18-24
26950,17650,9300,26,female,25-39
17500,15050,2450,31,Female,25-39
10350,6000,4350,18,male,18-24
22050,13050,9000,27,male,25-39
41350,15150,26200,19,female,18-24
15950,7900,8050,27,female,25-39
25350,10700,14650,27,male,25-39
22700,15050,7650,33,Female,25-39
8850,7100,1750,18,male,18-24
15950,13650,2300,26,male,25-39
23100,11350,11750,39,Female,25-39
35400,18500,16900,18,female,18-24
9850,8850,1000,20,male,18-24
8600,8250,350,18,male,18-24
22400,12200,10200,35,Female,25-39
10400,7750,2650,20,male,18-24
113750,36900,76850,24,male,18-24
123250,38450,84800,24,male,18-24
8250,7100,1150,18,male,18-24
9100,7500,1600,18,male,18-24
44850,20500,24350,21,female,18-24
20400,9100,11300,38,Female,25-39
10650,7200,3450,19,male,18-24
41400,13150,28250,22,female,18-24
19400,11700,7700,28,male,25-39
103200,33500,69700,23,male,18-24
11250,9150,2100,18,male,18-24
19450,11200,8250,34,male,25-39
51450,18450,33000,24,female,18-24
128500,45350,83150,22,male,18-24
10100,6850,3250,18,male,18-24
110450,39400,71050,23,male,18-24
47300,19400,27900,21,female,18-24
8900,7950,950,18,male,18-24
9300,6300,3000,19,male,18-24
53850,21800,32050,21,female,18-24
45800,12200,33600,18,female,18-24
4700,7650,-2950,19,male,18-24
12100,7850,4250,19,male,18-24
18350,7800,10550,31,Female,25-39
10700,10200,500,19,male,18-24
51450,17600,33850,21,female,18-24
37700,20300,17400,18,female,18-24
7500,7950,-450,18,male,18-24
43250,8000,35250,18,female,18-24
8800,8350,450,19,male,18-24
49650,18800,30850,22,female,18-24
47550,16750,30800,23,female,18-24
9600,7100,2500,18,male,18-24
9500,8750,750,20,male,18-24
8050,8300,-250,19,male,18-24
9700,8050,1650,19,male,18-24
9250,6750,2500,19,male,18-24
12000,8100,3900,18,male,18-24
21550,11800,9750,34,male,25-39
39150,15450,23700,18,female,18-24
44750,15150,29600,18,female,18-24
8100,7900,200,19,male,18-24
41600,10700,30900,19,female,18-24
60000,16600,43400,21,female,18-24
17950,7650,10300,37,male,25-39
10100,8300,1800,19,male,18-24
58350,13900,44450,19,female,18-24
17550,14500,3050,35,Female,25-39
9950,8700,1250,20,male,18-24
20450,8750,11700,32,Female,25-39
19850,9300,10550,27,female,25-39
39050,16050,23000,18,female,18-24
136350,37550,98800,21,male,18-24
31150,12400,18750,19,female,18-24
11900,7050,4850,19,male,18-24
47450,19100,28350,19,female,18-24
21150,10300,10850,32,Female,25-39
13500,8050,5450,19,male,18-24
16050,9200,6850,31,male,25-39
22150,11850,10300,31,Female,25-39
10750,7250,3500,18,male,18-24
18050,9100,8950,34,Female,25-39
38650,15200,23450,19,female,18-24
31300,15800,15500,18,female,18-24
114000,44750,69250,21,male,18-24
7150,7300,-150,20,male,18-24
53950,22250,31700,23,female,18-24
37850,14850,23000,18,female,18-24
35250,10450,24800,18,female,18-24
19200,16700,2500,27,female,25-39
10550,9250,1300,19,male,18-24
141300,44100,97200,22,male,18-24
17900,9450,8450,29,FEMALE,25-39
22050,9350,12700,27,female,25-39
16600,10750,5850,36,Female,25-39
29700,13650,16050,18,female,18-24
45050,17350,27700,19,female,18-24
34450,12450,22000,18,female,18-24
21700,12550,9150,36,male,25-39
5350,7750,-2400,19,male,18-24
37550,9200,28350,18,female,18-24
12500,8750,3750,20,male,18-24
6700,8650,-1950,18,male,18-24
24900,11900,13000,33,Female,25-39
18950,13750,5200,32,Female,25-39
10500,9300,1200,20,male,18-24
24750,16050,8700,29,FEMALE,25-39
132950,42900,90050,21,male,18-24
20000,13150,6850,35,Female,25-39
58650,13700,44950,19,female,18-24
41300,12750,28550,18,female,18-24
25300,11150,14150,25,female,25-39
37200,17500,19700,18,female,18-24
12900,12600,300,27,male,25-39
12050,9000,3050,19,male,18-24
8950,9400,-450,19,male,18-24
43450,20450,23000,21,female,18-24
8250,6700,1550,19,male,18-24
50000,18700,31300,18,female,18-24
21550,11900,9650,26,male,25-39
9600,6900,2700,18,male,18-24
11300,7100,4200,19,male,18-24
48000,20050,27950,19,female,18-24
9550,5650,3900,18,male,18-24
46700,11650,35050,18,female,18-24
57250,19650,37600,23,female,18-24
127200,40750,86450,21,male,18-24
118800,43950,74850,23,male,18-24
17850,14000,3850,25,male,25-39
43600,11450,32150,18,female,18-24
41000,18050,22950,19,female,18-24
42950,13000,29950,19,female,18-24
41850,17200,24650,19,female,18-24
42350,23150,19200,21,female,18-24
66950,11200,55750,21,female,18-24
9500,6150,3350,19,male,18-24
5300,6300,-1000,19,male,18-24
47200,14500,32700,18,female,18-24
8600,6100,2500,19,male,18-24
8750,8250,500,19,male,18-24
14550,7950,6600,20,male,18-24
133500,46900,86600,21,male,18-24
8600,8350,250,19,male,18-24
9750,7600,2150,18,male,18-24
10650,7450,3200,20,male,18-24
128650,36300,92350,24,male,18-24
130050,46050,84000,22,male,18-24
31650,18900,12750,18,female,18-24
10500,7150,3350,18,male,18-24
15150,7600,7550,20,male,18-24
122800,38500,84300,21,male,18-24
9000,8350,650,18,male,18-24
31100,14950,16150,30,FEMALE,25-39
10850,8450,2400,20,male,18-24
8000,7200,800,19,male,18-24
28950,14000,14950,19,female,18-24
36600,11600,25000,18,female,18-24
7900,7450,450,20,male,18-24
53750,9950,43800,18,female,18-24
12550,7500,5050,18,male,18-24
12750,8650,4100,18,male,18-24
21400,14200,7200,32,Female,25-39
27000,15100,11900,18,female,18-24
8850,8550,300,19,male,18-24
130150,38550,91600,24,male,18-24
129550,47050,82500,21,male,18-24
19000,13000,6000,30,male,25-39
12300,8550,3750,19,male,18-24
11300,10700,600,18,male,18-24
16150,11950,4200,36,Female,25-39
44950,14600,30350,19,female,18-24
21950,9950,12000,29,male,25-39
111000,38900,72100,21,male,18-24
119750,36950,82800,22,male,18-24
13900,8300,5600,29,FEMALE,25-39
20250,12800,7450,34,Female,25-39
12800,14400,-1600,25,male,25-39
18300,11000,7300,25,female,25-39
11800,6750,5050,19,male,18-24
51900,13500,38400,19,female,18-24
9700,7350,2350,18,male,18-24
10950,4750,6200,19,male,18-24
35200,20800,14400,22,female,18-24
25550,11950,13600,36,male,25-39
49400,11750,37650,19,female,18-24
9700,7950,1750,19,male,18-24
42450,12650,29800,19,female,18-24
5750,8800,-3050,18,male,18-24
14400,11300,3100,28,male,25-39
37500,18450,19050,19,female,18-24
19900,9350,10550,25,male,25-39
33250,14100,19150,19,female,18-24
13250,5800,7450,20,male,18-24
14950,7900,7050,19,male,18-24
129950,41300,88650,23,male,18-24
48700,19850,28850,23,female,18-24
12450,6850,5600,18,male,18-24
8850,7450,1400,18,male,18-24
10900,8650,2250,19,male,18-24
42100,10150,31950,18,female,18-24
94700,39350,55350,21,male,18-24
121200,36750,84450,23,male,18-24
10900,9000,1900,19,male,18-24
10250,6600,3650,19,male,18-24
63900,17650,46250,22,female,18-24
21550,12800,8750,34,Female,25-39
20150,7700,12450,28,male,25-39
33700,10550,23150,18,female,18-24
10050,8950,1100,18,male,18-24
12450,8700,3750,18,male,18-24
25850,12750,13100,32,male,25-39
31650,13850,17800,18,female,18-24
120600,35750,84850,21,male,18-24
13650,8500,5150,18,male,18-24
13100,6600,6500,18,male,18-24
45050,20650,24400,19,female,18-24
51450,23400,28050,21,female,18-24
40050,12800,27250,18,female,18-24
24900,14450,10450,37,male,25-39
117300,44050,73250,21,male,18-24
9300,6500,2800,19,male,18-24
10000,8150,1850,20,male,18-24
59150,20950,38200,21,female,18-24
12600,8700,3900,18,male,18-24
22450,10950,11500,27,female,25-39
15600,8850,6750,27,female,25-39
17450,13150,4300,36,male,25-39
22550,12100,10450,33,male,25-39
23350,6650,16700,25,female,25-39
39250,14050,25200,19,female,18-24
11000,11900,-900,28,male,25-39
6450,7150,-700,18,male,18-24
44800,10950,33850,19,female,18-24
22400,10150,12250,30,FEMALE,25-39
60000,12850,47150,19,female,18-24
49300,22050,27250,22,female,18-24
52650,23450,29200,21,female,18-24
8250,8600,-350,18,male,18-24
20350,12700,7650,37,Female,25-39
26200,11300,14900,33,Female,25-39
7700,9400,-1700,18,male,18-24
11550,8550,3000,18,male,18-24
10350,9200,1150,19,male,18-24
33100,13100,20000,19,female,18-24
42200,10650,31550,19,female,18-24
11900,9400,2500,20,male,18-24
40400,20600,19800,19,female,18-24
10750,7300,3450,20,male,18-24
9250,7350,1900,20,male,18-24
39400,13950,25450,18,female,18-24
28800,12950,15850,19,female,18-24
24050,10300,13750,31,male,25-39
25900,10600,15300,34,male,25-39
133250,53800,79450,22,male,18-24
24100,8750,15350,35,Female,25-39
32900,18250,14650,19,female,18-24
13500,9400,4100,18,male,18-24
30050,15850,14200,18,female,18-24
10200,8300,1900,19,male,18-24
41550,16150,25400,18,female,18-24
40050,8500,31550,18,female,18-24
50750,21750,29000,18,female,18-24
112050,34600,77450,22,male,18-24
31700,16500,15200,19,female,18-24
51350,24450,26900,22,female,18-24
122400,37350,85050,21,male,18-24
20850,11450,9400,35,Female,25-39
25750,10150,15600,26,female,25-39
8050,8050,0,19,male,18-24
9700,8250,1450,19,male,18-24
16950,10400,6550,27,male,25-39
10300,8000,2300,19,male,18-24
129400,39000,90400,22,male,18-24
24600,11700,12900,32,male,25-39
27200,10050,17150,37,Female,25-39
11600,5650,5950,19,male,18-24
19600,14250,5350,33,Female,25-39
37800,12500,25300,18,female,18-24
115200,39600,75600,21,male,18-24
21350,12400,8950,37,Female,25-39
23450,15100,8350,19,female,18-24
32300,15500,16800,18,female,18-24
23250,11400,11850,29,FEMALE,25-39
53750,13600,40150,18,female,18-24
16900,14450,2450,29,male,25-39
12400,8650,3750,20,male,18-24
10900,8800,2100,20,male,18-24
42600,18200,24400,18,female,18-24
47250,17250,30000,24,female,18-24
10000,7650,2350,19,male,18-24
12150,8350,3800,20,male,18-24
18900,10050,8850,36,Female,25-39
8150,8400,-250,19,male,18-24
7850,8900,-1050,18,male,18-24
9300,8300,1000,20,male,18-24
11650,7700,3950,18,male,18-24
43700,17600,26100,18,female,18-24
39250,17850,21400,18,female,18-24
119150,49550,69600,21,male,18-24
18450,14100,4350,30,FEMALE,25-39
6800,6700,100,18,male,18-24
23350,12650,10700,34,male,25-39
20000,11650,8350,32,Female,25-39
32650,12800,19850,18,female,18-24
10650,10600,50,19,male,18-24
12100,7100,5000,20,male,18-24
15600,18500,-2900,19,female,18-24
11150,8600,2550,18,male,18-24
24750,11650,13100,30,male,25-39
6450,7350,-900,19,male,18-24
36800,13750,23050,19,female,18-24
25750,12500,13250,35,male,25-39
8950,8850,100,18,male,18-24
18000,15300,2700,36,Female,25-39
10550,8650,1900,18,male,18-24
17050,9900,7150,35,Female,25-39
21800,10750,11050,28,FEMALE,25-39
38750,14050,24700,18,female,18-24
16500,11350,5150,27,female,25-39
9500,8300,1200,18,male,18-24
23100,11600,11500,36,male,25-39
8550,8650,-100,20,male,18-24
127050,36850,90200,21,male,18-24
7950,8800,-850,18,male,18-24
42550,13700,28850,19,female,18-24
20050,13100,6950,31,Female,25-39
40300,10300,30000,18,female,18-24
11300,10550,750,20,male,18-24
21850,10400,11450,33,male,25-39
24600,9600,15000,32,male,25-39
19700,9800,9900,30,FEMALE,25-39
18600,11950,6650,25,male,25-39
10700,7400,3300,20,male,18-24
12250,8950,3300,20,male,18-24
45500,18950,26550,19,female,18-24
20550,13750,6800,25,female,25-39
19950,10350,9600,39,male,25-39
35250,11050,24200,18,female,18-24
19800,15950,3850,31,Female,25-39
27000,15650,11350,19,female,18-24
8400,7250,1150,20,male,18-24
29600,10500,19100,30,FEMALE,25-39
10050,7400,2650,19,male,18-24
6250,7550,-1300,19,male,18-24
54500,17000,37500,18,female,18-24
42700,15350,27350,19,female,18-24
47150,23450,23700,24,female,18-24
23100,10250,12850,37,male,25-39
49950,12000,37950,22,female,18-24
7950,7700,250,20,male,18-24
10000,6650,3350,19,male,18-24
19150,13950,5200,31,Female,25-39
14650,10400,4250,30,male,25-39
12800,9250,3550,18,male,18-24
29400,16300,13100,18,female,18-24
9350,6700,2650,19,male,18-24
26000,12800,13200,32,male,25-39
13050,12000,1050,31,Female,25-39
10000,8900,1100,19,male,18-24
39750,12150,27600,19,female,18-24
13450,8650,4800,18,male,18-24
30050,19500,10550,20,female,18-24
39700,21100,18600,18,female,18-24
22150,9750,12400,29,male,25-39
6750,7950,-1200,19,male,18-24
11700,7300,4400,18,male,18-24
8100,9200,-1100,18,male,18-24
9500,7200,2300,19,male,18-24
14950,15000,-50,31,Female,25-39
118500,33550,84950,21,male,18-24
14950,12700,2250,27,male,25-39
8950,7400,1550,20,male,18-24
5750,6800,-1050,20,male,18-24
7550,8550,-1000,19,male,18-24
9950,8450,1500,20,male,18-24
19200,14950,4250,28,female,25-39
9000,8200,800,19,male,18-24
11750,7750,4000,19,male,18-24
9100,7450,1650,18,male,18-24
17100,11800,5300,30,male,25-39
10350,8200,2150,18,male,18-24
10150,7650,2500,18,male,18-24
17950,13250,4700,34,male,25-39
9700,8350,1350,19,male,18-24
9800,7300,2500,19,male,18-24
33750,13650,20100,19,female,18-24
10950,12400,-1450,28,female,25-39
21650,14050,7600,33,Female,25-39
25200,9450,15750,29,FEMALE,25-39
13500,10900,2600,18,male,18-24
12450,8100,4350,18,male,18-24
12400,8100,4300,18,male,18-24
7050,6350,700,19,male,18-24
44200,24150,20050,23,female,18-24
12650,7850,4800,20,male,18-24
37250,10150,27100,19,female,18-24
10400,9250,1150,20,male,18-24
24950,12500,12450,38,Female,25-39
20350,12950,7400,29,male,25-39
11700,6400,5300,18,male,18-24
74500,23700,50800,24,female,18-24
9600,6450,3150,18,male,18-24
10900,9400,1500,19,male,18-24
14750,11950,2800,33,male,25-39
46500,20350,26150,22,female,18-24
19400,9150,10250,28,female,25-39
51800,14800,37000,18,female,18-24
40450,12400,28050,18,female,18-24
35300,11050,24250,20,female,18-24
11300,7250,4050,18,male,18-24
17250,16000,1250,38,Female,25-39
40150,12150,28000,18,female,18-24
46950,14500,32450,19,female,18-24
22850,14400,8450,27,male,25-39
10600,7800,2800,19,male,18-24
11150,11750,-600,41,female,40+
47800,21700,26100,18,female,18-24
11850,8400,3450,18,male,18-24
12950,8550,4400,20,male,18-24
45350,15950,29400,18,female,18-24
12600,8400,4200,19,male,18-24
19600,15000,4600,30,FEMALE,25-39
18000,13300,4700,30,male,25-39
39050,9800,29250,18,female,18-24
120150,39600,80550,21,male,18-24
13500,7800,5700,27,female,25-39
16750,10250,6500,32,Female,25-39
42700,17800,24900,21,female,18-24
21700,11550,10150,31,male,25-39
19050,11150,7900,38,Female,25-39
36900,21850,15050,18,female,18-24
109700,38850,70850,21,male,18-24
38500,19750,18750,18,female,18-24
11700,8850,2850,27,female,25-39
41000,13600,27400,19,female,18-24
17950,12750,5200,31,Female,25-39
24800,13500,11300,37,Female,25-39
9450,10200,-750,18,male,18-24
24450,10800,13650,35,Female,25-39
9150,9450,-300,19,male,18-24
20850,12000,8850,37,Female,25-39
46350,16300,30050,18,female,18-24
18200,12500,5700,33,male,25-39
37500,15450,22050,19,female,18-24
9150,6150,3000,18,male,18-24
10100,6200,3900,19,male,18-24
9850,7750,2100,18,male,18-24
6500,8750,-2250,19,male,18-24
8100,7550,550,18,male,18-24
36550,15150,21400,19,female,18-24
25400,13300,12100,35,Female,25-39
8550,9400,-850,18,male,18-24
44100,20100,24000,18,female,18-24
24300,10400,13900,30,FEMALE,25-39
8900,8100,800,18,male,18-24
47400,20400,27000,24,female,18-24
49950,21100,28850,21,female,18-24
21400,11900,9500,35,male,25-39
44700,14850,29850,18,female,18-24
30250,17100,13150,19,female,18-24
115600,37700,77900,21,male,18-24
39200,15500,23700,18,female,18-24
19900,10450,9450,29,male,25-39
9400,6300,3100,20,male,18-24
18800,12750,6050,37,Female,25-39
20850,12450,8400,26,male,25-39
10600,9900,700,19,male,18-24
22200,9500,12700,27,female,25-39
7900,7950,-50,19,male,18-24
21000,9950,11050,30,FEMALE,25-39
12150,10550,1600,20,male,18-24
41250,11800,29450,21,female,18-24
43350,18650,24700,24,female,18-24
54550,17600,36950,21,female,18-24
19000,9150,9850,33,Female,25-39
12500,8300,4200,19,male,18-24
19000,14300,4700,31,Female,25-39
23200,13150,10050,18,female,18-24
20550,12900,7650,33,Female,25-39
12200,7150,5050,20,male,18-24
23200,10050,13150,29,FEMALE,25-39
7000,6450,550,18,male,18-24
10450,8300,2150,18,male,18-24
11900,7650,4250,18,male,18-24
40800,11250,29550,18,female,18-24
51300,17600,33700,18,female,18-24
4600,8350,-3750,18,male,18-24
126750,44750,82000,21,male,18-24
31200,16950,14250,37,male,25-39
125150,45900,79250,22,male,18-24
37600,19800,17800,18,female,18-24
14750,12600,2150,30,FEMALE,25-39
21900,12100,9800,33,Female,25-39
16550,15300,1250,28,FEMALE,25-39
48600,24150,24450,18,female,18-24
22500,12550,9950,28,male,25-39
138850,38800,100050,22,male,18-24
19650,12050,7600,33,Female,25-39
10700,8650,2050,19,male,18-24
12150,10350,1800,39,Female,25-39
137950,32700,105250,21,male,18-24
21350,9500,11850,35,male,25-39
7300,7750,-450,19,male,18-24
48150,10900,37250,18,female,18-24
45700,15800,29900,19,female,18-24
30850,16350,14500,18,female,18-24
22700,13350,9350,27,male,25-39
61150,27150,34000,23,female,18-24
17000,15250,1750,39,Female,25-39
19350,14700,4650,29,FEMALE,25-39
22300,13400,8900,32,Female,25-39
14050,7950,6100,19,male,18-24
10900,6400,4500,19,male,18-24
8850,13250,-4400,27,female,25-39
9300,8800,500,20,male,18-24
117350,42500,74850,21,male,18-24
20250,11000,9250,35,male,25-39
49400,16500,32900,18,female,18-24
33200,18600,14600,18,female,18-24
44300,10850,33450,23,female,18-24
17200,9700,7500,27,male,25-39
104700,41050,63650,21,male,18-24
17350,9950,7400,28,male,25-39
22250,11700,10550,29,male,25-39
122550,42900,79650,21,male,18-24
8500,7800,700,18,male,18-24
37600,16150,21450,18,female,18-24
9700,7150,2550,20,male,18-24
25800,13000,12800,18,female,18-24
12500,8050,4450,18,male,18-24
52900,21350,31550,21,female,18-24
9600,8300,1300,19,male,18-24
11100,10500,600,19,male,18-24
22900,13100,9800,32,male,25-39
10500,8300,2200,18,male,18-24
12950,9050,3900,18,male,18-24
49750,14300,35450,19,female,18-24
11650,8900,2750,18,male,18-24
7300,8350,-1050,19,male,18-24
59600,23750,35850,24,female,18-24
40550,11250,29300,19,female,18-24
11700,8250,3450,18,male,18-24
26650,12200,14450,32,Female,25-39
52700,13150,39550,18,female,18-24
37150,13950,23200,19,female,18-24
19050,12900,6150,39,Female,25-39
45350,25800,19550,22,female,18-24
9850,7800,2050,18,male,18-24
48300,14050,34250,18,female,18-24
8600,8050,550,18,male,18-24
22550,14200,8350,35,male,25-39
58100,17350,40750,18,female,18-24
12300,11850,450,26,female,25-39
47600,17150,30450,19,female,18-24
11050,7650,3400,18,male,18-24
21150,9600,11550,29,male,25-39
18800,12900,5900,35,Female,25-39
9150,8150,1000,19,male,18-24
11250,7950,3300,20,male,18-24
9650,7950,1700,20,male,18-24
52700,14750,37950,18,female,18-24
50850,22400,28450,21,female,18-24
18050,12850,5200,27,female,25-39
10750,7450,3300,20,male,18-24
17150,10350,6800,30,FEMALE,25-39
17150,11050,6100,26,female,25-39
9050,7800,1250,18,male,18-24
29500,12400,17100,28,male,25-39
42550,17100,25450,21,female,18-24
8800,7050,1750,20,male,18-24
8600,8450,150,19,male,18-24
37000,15750,21250,18,female,18-24
39400,11900,27500,19,female,18-24
23650,11900,11750,35,Female,25-39
27800,14150,13650,31,male,25-39
9250,11500,-2250,41,female,40+
21450,10200,11250,33,male,25-39
10800,6800,4000,18,male,18-24
138300,47100,91200,23,male,18-24
17650,10200,7450,31,Female,25-39
11050,6850,4200,20,male,18-24
127300,42750,84550,22,male,18-24
11000,9850,1150,20,male,18-24
10150,6750,3400,18,male,18-24
48750,24800,23950,22,female,18-24
16900,9700,7200,30,male,25-39
137150,49150,88000,21,male,18-24
120550,37150,83400,21,male,18-24
11850,8250,3600,19,male,18-24
41600,19800,21800,18,female,18-24
9800,8750,1050,18,male,18-24
128350,33400,94950,22,male,18-24
43550,10350,33200,19,female,18-24
23200,15050,8150,18,female,18-24
10350,8850,1500,18,male,18-24
13600,9750,3850,35,male,25-39
13550,17100,-3550,34,male,25-39
12300,8550,3750,19,male,18-24
11900,7550,4350,19,male,18-24
8700,6800,1900,18,male,18-24
12800,7200,5600,19,male,18-24
43950,19600,24350,19,female,18-24
25200,13000,12200,29,male,25-39
33500,16450,17050,18,female,18-24
12650,6750,5900,18,male,18-24
20200,11500,8700,34,male,25-39
8650,7200,1450,18,male,18-24
35450,13050,22400,19,female,18-24
30350,11900,18450,19,female,18-24
8550,10050,-1500,20,male,18-24
44850,15900,28950,18,female,18-24
47500,15800,31700,19,female,18-24
40350,9850,30500,19,female,18-24
19550,9700,9850,28,male,25-39
11050,6800,4250,18,male,18-24
8650,6850,1800,20,male,18-24
39250,9700,29550,18,female,18-24
10700,7450,3250,19,male,18-24
8300,6900,1400,20,male,18-24
107300,44250,63050,21,male,18-24
14850,11900,2950,34,Female,25-39
10900,9100,1800,19,male,18-24
21400,12150,9250,28,FEMALE,25-39
31600,19600,12000,21,female,18-24
9150,6850,2300,19,male,18-24
8950,9000,-50,19,male,18-24
27200,15600,11600,38,male,25-39
22650,12450,10200,30,male,25-39
11150,8950,2200,18,male,18-24
137500,38300,99200,21,male,18-24
93700,41250,52450,23,male,18-24
19000,13950,5050,32,Female,25-39
33650,14400,19250,18,female,18-24
42200,19150,23050,18,female,18-24
41150,18000,23150,18,female,18-24
24050,7650,16400,31,male,25-39
12000,8200,3800,20,male,18-24
8450,6150,2300,19,male,18-24
14200,7150,7050,18,male,18-24
9250,8750,500,19,male,18-24
52850,21300,31550,18,female,18-24
103000,42550,60450,22,male,18-24
8600,8100,500,20,male,18-24
8650,8950,-300,18,male,18-24
10250,9450,800,19,male,18-24
16400,13800,2600,31,Female,25-39
13800,11850,1950,36,Female,25-39
62950,16350,46600,21,female,18-24
22500,10650,11850,27,male,25-39
25450,18350,7100,19,female,18-24
109700,32300,77400,21,male,18-24
7200,5750,1450,18,male,18-24
32600,15650,16950,18,female,18-24
24300,14700,9600,19,female,18-24
38850,11250,27600,18,female,18-24
7150,7550,-400,18,male,18-24
18900,12550,6350,33,male,25-39
14950,11750,3200,28,male,25-39
11250,8900,2350,18,male,18-24
39050,13450,25600,18,female,18-24
60600,26050,34550,22,female,18-24
9700,6700,3000,19,male,18-24
31900,17700,14200,18,female,18-24
52450,16950,35500,18,female,18-24
58300,20650,37650,23,female,18-24
123600,43100,80500,22,male,18-24
17350,9550,7800,30,FEMALE,25-39
30250,14200,16050,19,female,18-24
43950,13400,30550,18,female,18-24
43350,16600,26750,18,female,18-24
21950,10200,11750,31,Female,25-39
22700,10750,11950,31,male,25-39
12050,8750,3300,19,male,18-24
137300,38400,98900,24,male,18-24
12650,7900,4750,19,male,18-24
38850,12500,26350,19,female,18-24
43500,22300,21200,21,female,18-24
20700,8450,12250,31,male,25-39
36800,17100,19700,18,female,18-24
43950,15400,28550,19,female,18-24
22300,10900,11400,35,male,25-39
35900,16550,19350,19,female,18-24
27300,12800,14500,27,female,25-39
9300,9350,-50,30,FEMALE,25-39
40600,18800,21800,19,female,18-24
30950,11500,19450,19,female,18-24
21650,13150,8500,27,male,25-39
15100,11000,4100,33,male,25-39
10150,8650,1500,18,male,18-24
118600,43800,74800,21,male,18-24
9350,7600,1750,18,male,18-24
6350,6400,-50,18,male,18-24
35250,11350,23900,18,female,18-24
123850,34250,89600,21,male,18-24
8350,7850,500,18,male,18-24
10700,8950,1750,18,male,18-24
8300,7700,600,18,male,18-24
18450,8900,9550,29,FEMALE,25-39
120100,47650,72450,22,male,18-24
37250,11500,25750,19,female,18-24
17400,10150,7250,34,Female,25-39
18350,13400,4950,35,Female,25-39
7350,7950,-600,19,male,18-24
10850,7550,3300,19,male,18-24
38900,11300,27600,19,female,18-24
119900,45600,74300,22,male,18-24
41000,11850,29150,22,female,18-24
16000,12300,3700,29,FEMALE,25-39
38800,14050,24750,19,female,18-24
50350,16150,34200,18,female,18-24
40750,17900,22850,18,female,18-24
9150,8800,350,18,male,18-24
45900,13700,32200,18,female,18-24
22000,8400,13600,30,male,25-39
12900,6450,6450,20,male,18-24
11900,12350,-450,42,female,40+
40600,12650,27950,19,female,18-24
9850,8450,1400,19,male,18-24
48800,17300,31500,18,female,18-24
21400,18250,3150,19,female,18-24
18400,7950,10450,31,Female,25-39
112600,39950,72650,21,male,18-24
10150,8500,1650,19,male,18-24
12550,7000,5550,19,male,18-24
62800,25850,36950,22,female,18-24
12150,13900,-1750,40,female,40+
31750,10250,21500,19,female,18-24
39600,15950,23650,18,female,18-24
51650,24000,27650,21,female,18-24
137200,41700,95500,23,male,18-24
11350,7400,3950,18,male,18-24
9850,7900,1950,18,male,18-24
20300,11600,8700,25,male,25-39
8550,10700,-2150,49,male,40+
39550,15000,24550,19,female,18-24
36450,18300,18150,18,female,18-24
19400,12300,7100,26,male,25-39
33250,18450,14800,18,female,18-24
35400,12000,23400,19,female,18-24
6200,8250,-2050,18,male,18-24
9600,8700,900,20,male,18-24
32850,12150,20700,19,female,18-24
34950,13050,21900,18,female,18-24
20600,8500,12100,36,Female,25-39
10750,6950,3800,18,male,18-24
112800,43800,69000,21,male,18-24
42250,16600,25650,20,female,18-24
10100,8050,2050,18,male,18-24
17450,16950,500,29,FEMALE,25-39
53600,28550,25050,21,female,18-24
42100,15150,26950,18,female,18-24
32900,15500,17400,18,female,18-24
18350,11400,6950,32,Female,25-39
8800,7050,1750,19,male,18-24
37950,21500,16450,18,female,18-24
21650,6700,14950,37,Female,25-39
7800,6400,1400,19,male,18-24
10300,9250,1050,20,male,18-24
26550,10950,15600,25,female,25-39
19850,10850,9000,26,male,25-39
41300,19750,21550,18,female,18-24
36050,20500,15550,22,female,18-24
55300,19100,36200,22,female,18-24
20550,11900,8650,27,male,25-39
12650,8050,4600,20,male,18-24
9950,6150,3800,20,male,18-24
20450,10550,9900,36,male,25-39
30950,13350,17600,33,male,25-39
126450,34400,92050,24,male,18-24
13850,8850,5000,19,male,18-24
24150,9500,14650,28,male,25-39
36000,17850,18150,20,female,18-24
27600,12150,15450,39,male,25-39
14950,9150,5800,20,male,18-24
19250,14200,5050,30,FEMALE,25-39
12400,9200,3200,19,male,18-24
9550,7500,2050,18,male,18-24
21350,11850,9500,26,female,25-39
29600,11800,17800,32,male,25-39
11800,9500,2300,18,male,18-24
34600,20350,14250,19,female,18-24
49150,22400,26750,22,female,18-24
48950,17100,31850,18,female,18-24
38650,16950,21700,24,female,18-24
41100,12850,28250,18,female,18-24
8150,7350,800,19,male,18-24
16250,9750,6500,35,Female,25-39
11900,8350,3550,18,male,18-24
22400,12950,9450,34,Female,25-39
10900,7800,3100,20,male,18-24
35000,17900,17100,18,female,18-24
16150,14900,1250,34,Female,25-39
54650,20450,34200,24,female,18-24
25200,12000,13200,31,Female,25-39
22150,11650,10500,32,male,25-39
41400,16400,25000,18,female,18-24
39450,13900,25550,18,female,18-24
27100,13350,13750,18,female,18-24
45400,13950,31450,18,female,18-24
103350,39200,64150,23,male,18-24
10550,8300,2250,19,male,18-24
16000,12650,3350,31,male,25-39
14750,13700,1050,28,FEMALE,25-39
52600,14050,38550,18,female,18-24
22700,17500,5200,19,female,18-24
114200,39350,74850,22,male,18-24
18800,12050,6750,35,male,25-39
10400,6700,3700,18,male,18-24
14050,8700,5350,20,male,18-24
26550,12200,14350,36,male,25-39
7850,8050,-200,20,male,18-24
22050,9100,12950,26,female,25-39
20550,13500,7050,26,female,25-39
16950,13250,3700,36,Female,25-39
61950,19250,42700,21,female,18-24
53200,22800,30400,22,female,18-24
9400,8350,1050,20,male,18-24
22350,11700,10650,32,male,25-39
21200,8550,12650,36,male,25-39
25250,16250,9000,18,female,18-24
41300,17700,23600,18,female,18-24
10800,8200,2600,18,male,18-24
47650,16650,31000,18,female,18-24
43250,10850,32400,18,female,18-24
9250,7900,1350,19,male,18-24
9550,7250,2300,18,male,18-24
17150,12650,4500,35,male,25-39
7750,6850,900,18,male,18-24
7450,7150,300,20,male,18-24
53900,22350,31550,19,female,18-24
9200,9350,-150,18,male,18-24
15300,10500,4800,29,FEMALE,25-39
128700,44600,84100,21,male,18-24
42950,15050,27900,18,female,18-24
13100,7300,5800,20,male,18-24
5850,7400,-1550,18,male,18-24
28250,17750,10500,18,female,18-24
10250,8000,2250,19,male,18-24
109650,37950,71700,24,male,18-24
10850,7550,3300,19,male,18-24
115150,41000,74150,21,male,18-24
10550,7650,2900,18,male,18-24
9250,6250,3000,19,male,18-24
52100,18650,33450,21,female,18-24
11050,9550,1500,18,male,18-24
29850,12050,17800,19,female,18-24
10400,6950,3450,18,male,18-24
8200,6900,1300,18,male,18-24
9700,8150,1550,19,male,18-24
18000,11500,6500,32,Female,25-39
48950,10600,38350,18,female,18-24
44600,16700,27900,18,female,18-24
39600,15500,24100,18,female,18-24
37750,18400,19350,19,female,18-24
19800,10800,9000,27,female,25-39
17450,12100,5350,33,male,25-39
20250,11750,8500,38,Female,25-39
9850,6700,3150,18,male,18-24
9300,5950,3350,18,male,18-24
6300,8750,-2450,18,male,18-24
38800,12750,26050,19,female,18-24
8100,8850,-750,20,male,18-24
20750,12500,8250,28,male,25-39
55850,27150,28700,23,female,18-24
123600,37550,86050,22,male,18-24
41150,18400,22750,19,female,18-24
8550,8850,-300,19,male,18-24
12700,7200,5500,19,male,18-24
7750,7950,-200,18,male,18-24
41400,19850,21550,18,female,18-24
16450,12750,3700,35,Female,25-39
12250,6750,5500,19,male,18-24
9100,9150,-50,18,male,18-24
32500,15200,17300,19,female,18-24
9850,6900,2950,19,male,18-24
110400,39550,70850,23,male,18-24
9100,7650,1450,19,male,18-24
23550,11100,12450,32,male,25-39
39600,16950,22650,20,female,18-24
25700,12550,13150,31,Female,25-39
15250,12850,2400,36,male,25-39
128000,43450,84550,22,male,18-24
5150,7900,-2750,18,male,18-24
45950,18050,27900,18,female,18-24
9750,7600,2150,18,male,18-24
11100,8400,2700,20,male,18-24
10650,7200,3450,19,male,18-24
27750,9550,18200,36,male,25-39
25200,12100,13100,31,Female,25-39
44000,17900,26100,19,female,18-24
8150,7150,1000,18,male,18-24
42750,16250,26500,19,female,18-24
46450,12700,33750,19,female,18-24
15650,10350,5300,37,Female,25-39
21750,12000,9750,33,male,25-39
37350,18500,18850,18,female,18-24
56100,17650,38450,21,female,18-24
12550,9050,3500,18,male,18-24
7850,7350,500,18,male,18-24
9950,7550,2400,18,male,18-24
46950,14050,32900,21,female,18-24
46250,16700,29550,21,female,18-24
13950,9650,4300,35,Female,25-39
11400,8050,3350,19,male,18-24
14700,13350,1350,29,male,25-39
14250,7050,7200,18,male,18-24
19200,11200,8000,26,male,25-39
45600,13250,32350,18,female,18-24
26150,14350,11800,18,female,18-24
15950,12300,3650,34,Female,25-39
46000,21000,25000,18,female,18-24
36700,15200,21500,18,female,18-24
103400,40100,63300,21,male,18-24
41050,15350,25700,19,female,18-24
43500,14000,29500,19,female,18-24
9850,7150,2700,20,male,18-24
10500,7200,3300,20,male,18-24
10800,7900,2900,19,male,18-24
14100,13650,450,32,Female,25-39
33850,19200,14650,19,female,18-24
10300,7950,2350,18,male,18-24
20750,11400,9350,30,FEMALE,25-39
17950,13850,4100,34,Female,25-39
43200,18350,24850,19,female,18-24
23750,10650,13100,26,female,25-39
7000,7550,-550,18,male,18-24
8500,5100,3400,18,male,18-24
14300,11850,2450,31,Female,25-39
46600,13700,32900,18,female,18-24
30650,16200,14450,18,female,18-24
9250,7300,1950,19,male,18-24
10550,8350,2200,19,male,18-24
40450,15500,24950,19,female,18-24
37750,16700,21050,18,female,18-24
57450,18300,39150,22,female,18-24
20300,11200,9100,36,male,25-39
41750,16800,24950,18,female,18-24
128750,40450,88300,23,male,18-24
10100,8450,1650,20,male,18-24
40350,15750,24600,19,female,18-24
23850,8400,15450,26,female,25-39
45950,16150,29800,18,female,18-24
21200,11450,9750,25,female,25-39
42050,16450,25600,19,female,18-24
9300,6500,2800,18,male,18-24
22000,12000,10000,31,male,25-39
15500,14300,1200,32,Female,25-39
16800,11200,5600,39,male,25-39
9550,6400,3150,19,male,18-24
21300,12650,8650,26,male,25-39
9750,6900,2850,18,male,18-24
31600,20850,10750,18,female,18-24
8350,9100,-750,18,male,18-24
17300,10350,6950,34,male,25-39
14500,10850,3650,30,FEMALE,25-39
52600,15200,37400,19,female,18-24
21800,8150,13650,32,male,25-39
49900,17650,32250,18,female,18-24
55800,13700,42100,18,female,18-24
24200,15400,8800,33,male,25-39
8900,6850,2050,18,male,18-24
17300,9400,7900,26,female,25-39
8400,9450,-1050,18,male,18-24
21950,12000,9950,30,male,25-39
8600,8350,250,18,male,18-24
10150,7950,2200,20,male,18-24
55800,18800,37000,18,female,18-24
27100,11650,15450,37,Female,25-39
36350,15400,20950,18,female,18-24
5500,8600,-3100,19,male,18-24
12200,8300,3900,20,male,18-24
12450,9150,3300,18,male,18-24
130600,37650,92950,21,male,18-24
56900,15000,41900,19,female,18-24
7550,8750,-1200,19,male,18-24
43650,11650,32000,18,female,18-24
18200,13400,4800,28,male,25-39
47650,8750,38900,20,female,18-24
22550,12300,10250,28,female,25-39
38900,11250,27650,18,female,18-24
7550,7300,250,18,male,18-24
13250,13750,-500,25,female,25-39
55950,24050,31900,24,female,18-24
9250,7600,1650,19,male,18-24
7300,6600,700,18,male,18-24
43850,16000,27850,18,female,18-24
15500,9750,5750,36,male,25-39
13350,5800,7550,18,male,18-24
9600,7800,1800,19,male,18-24
14050,10750,3300,27,male,25-39
10850,7200,3650,20,male,18-24
25800,12800,13000,27,male,25-39
18900,12150,6750,25,female,25-39
42050,13000,29050,18,female,18-24
9350,7500,1850,19,male,18-24
69350,17850,51500,24,female,18-24
47300,15850,31450,18,female,18-24
8600,7600,1000,18,male,18-24
111550,40000,71550,21,male,18-24
46200,12400,33800,18,female,18-24
36250,12950,23300,19,female,18-24
20250,12900,7350,31,Female,25-39
59550,20400,39150,21,female,18-24
7500,7200,300,20,male,18-24
9750,8500,1250,18,male,18-24
18200,10700,7500,31,male,25-39
12150,7050,5100,20,male,18-24
41050,15800,25250,20,female,18-24
13350,12900,450,30,FEMALE,25-39
9250,6750,2500,20,male,18-24
40200,17400,22800,18,female,18-24
13600,6850,6750,18,male,18-24
9900,8450,1450,19,male,18-24
11450,8400,3050,19,male,18-24
10400,9000,1400,20,male,18-24
39700,25200,14500,21,female,18-24
12350,7300,5050,18,male,18-24
12750,7350,5400,19,male,18-24
10900,10650,250,40,male,40+
9300,7900,1400,18,male,18-24
27050,11250,15800,26,female,25-39
13300,8050,5250,19,male,18-24
9450,7250,2200,18,male,18-24
52150,17050,35100,18,female,18-24
22600,10350,12250,32,Female,25-39
30150,13800,16350,20,female,18-24
38500,10700,27800,20,female,18-24
22950,10500,12450,25,female,25-39
18800,10850,7950,26,male,25-39
11500,8100,3400,18,male,18-24
8500,8250,250,19,male,18-24
17200,12450,4750,35,male,25-39
111550,50500,61050,24,male,18-24
38950,17200,21750,19,female,18-24
36700,15800,20900,19,female,18-24
116250,35000,81250,21,male,18-24
24850,9200,15650,38,Female,25-39
18400,11450,6950,26,female,25-39
10150,13950,-3800,26,male,25-39
11800,8000,3800,18,male,18-24
32050,18550,13500,19,female,18-24
35050,13600,21450,18,female,18-24
11000,7350,3650,18,male,18-24
9300,8250,1050,19,male,18-24
10450,10100,350,19,male,18-24
9850,7650,2200,18,male,18-24
21500,9950,11550,25,female,25-39
44400,17550,26850,21,female,18-24
15050,10550,4500,36,Female,25-39
18900,16700,2200,32,male,25-39
38850,8600,30250,18,female,18-24
5400,7400,-2000,19,male,18-24
19950,10500,9450,32,Female,25-39
119200,38000,81200,21,male,18-24
11500,7750,3750,19,male,18-24
17250,8250,9000,34,Female,25-39
5400,8700,-3300,19,male,18-24
9850,6500,3350,18,male,18-24
9450,8850,600,18,male,18-24
37700,13050,24650,18,female,18-24
11300,8600,2700,19,male,18-24
43650,18550,25100,23,female,18-24
39750,16250,23500,18,female,18-24
130350,40200,90150,21,male,18-24
18050,12150,5900,30,FEMALE,25-39
53450,21250,32200,24,female,18-24
24000,18000,6000,18,female,18-24
22300,9900,12400,26,female,25-39
12400,8900,3500,19,male,18-24
10050,8500,1550,18,male,18-24
16650,12500,4150,25,male,25-39
9350,8050,1300,18,male,18-24
18700,12050,6650,35,Female,25-39
17050,13300,3750,31,Female,25-39
9150,9850,-700,18,male,18-24
22900,11600,11300,36,Female,25-39
54050,22800,31250,24,female,18-24
8700,9150,-450,18,male,18-24
13750,6050,7700,20,male,18-24
41900,14900,27000,18,female,18-24
14550,10450,4100,29,FEMALE,25-39
36200,19450,16750,18,female,18-24
13950,5700,8250,18,male,18-24
37550,19600,17950,19,female,18-24
20800,13850,6950,29,male,25-39
24900,10600,14300,18,female,18-24
23750,10900,12850,31,Female,25-39
10400,10550,-150,41,female,40+
8400,5800,2600,19,male,18-24
33700,16700,17000,18,female,18-24
24750,11600,13150,36,male,25-39
33950,14400,19550,18,female,18-24
9150,8800,350,20,male,18-24
32350,16200,16150,19,female,18-24
13350,8100,5250,18,male,18-24
45800,12800,33000,21,female,18-24
18800,11800,7000,27,male,25-39
10600,8750,1850,18,male,18-24
12050,8800,3250,18,male,18-24
10600,11450,-850,42,female,40+
10850,8250,2600,18,male,18-24
24000,12100,11900,38,male,25-39
19400,13750,5650,27,female,25-39
46700,8000,38700,19,female,18-24
8600,8500,100,20,male,18-24
124650,40850,83800,21,male,18-24
8750,8400,350,18,male,18-24
10650,8700,1950,18,male,18-24
24100,14700,9400,31,Female,25-39
11250,8100,3150,20,male,18-24
10100,6800,3300,19,male,18-24
18800,10650,8150,25,female,25-39
28600,11300,17300,27,male,25-39
17500,9250,8250,27,male,25-39
41100,20000,21100,18,female,18-24
7750,6650,1100,19,male,18-24
68150,14550,53600,19,female,18-24
8050,7950,100,18,male,18-24
124650,44850,79800,23,male,18-24
19200,10250,8950,27,male,25-39
18200,14000,4200,37,male,25-39
10250,7900,2350,19,male,18-24
125450,38750,86700,21,male,18-24
50200,22250,27950,21,female,18-24
12250,9900,2350,20,male,18-24
37800,23900,13900,24,female,18-24
12000,7000,5000,20,male,18-24
14500,12650,1850,39,Female,25-39
58400,15350,43050,23,female,18-24
10100,8350,1750,18,male,18-24
23650,13950,9700,31,male,25-39
41900,17950,23950,18,female,18-24
33600,13100,20500,19,female,18-24
10250,8800,1450,19,male,18-24
15250,12250,3000,33,Female,25-39
10650,8150,2500,18,male,18-24
16200,14550,1650,36,Female,25-39
12800,6750,6050,18,male,18-24
12150,6500,5650,20,male,18-24
52900,15700,37200,23,female,18-24
41950,15300,26650,18,female,18-24
119000,45700,73300,21,male,18-24
17800,12050,5750,34,male,25-39
44200,20650,23550,21,female,18-24
13250,11850,1400,37,male,25-39
13700,8150,5550,20,male,18-24
9100,6400,2700,20,male,18-24
43200,11400,31800,18,female,18-24
7700,8150,-450,19,male,18-24
48000,17050,30950,18,female,18-24
32200,13500,18700,19,female,18-24
27500,21200,6300,19,female,18-24
102300,39100,63200,22,male,18-24
21550,7500,14050,29,FEMALE,25-39
10900,7850,3050,18,male,18-24
8150,8250,-100,19,male,18-24
13450,7700,5750,18,male,18-24
50200,10200,40000,18,female,18-24
42700,19750,22950,19,female,18-24
18300,13800,4500,27,male,25-39
9550,8100,1450,19,male,18-24
7600,8150,-550,18,male,18-24
9600,7550,2050,18,male,18-24
45450,14600,30850,18,female,18-24
33650,15050,18600,18,female,18-24
9350,7200,2150,18,male,18-24
41250,18800,22450,18,female,18-24
12350,6700,5650,19,male,18-24
33600,12250,21350,18,female,18-24
8300,8900,-600,18,male,18-24
14900,10200,4700,28,male,25-39
10800,7250,3550,18,male,18-24
6750,7100,-350,18,male,18-24
12950,7850,5100,18,male,18-24
123650,42600,81050,23,male,18-24
9600,9350,250,19,male,18-24
37000,12800,24200,18,female,18-24
11300,6950,4350,19,male,18-24
49450,8900,40550,18,female,18-24
30850,13800,17050,19,female,18-24
12400,7250,5150,18,male,18-24
42800,12000,30800,18,female,18-24
26800,13750,13050,34,Female,25-39
22400,11200,11200,27,female,25-39
109650,36250,73400,23,male,18-24
121350,40450,80900,23,male,18-24
32500,11700,20800,19,female,18-24
9600,5750,3850,20,male,18-24
35450,16700,18750,19,female,18-24
12450,7450,5000,18,male,18-24
32900,12950,19950,18,female,18-24
18550,14300,4250,30,male,25-39
53650,20100,33550,21,female,18-24
33750,13550,20200,18,female,18-24
39900,19100,20800,18,female,18-24
12150,7450,4700,18,male,18-24
111250,41700,69550,24,male,18-24
54700,18250,36450,22,female,18-24
10400,8650,1750,18,male,18-24
8600,8050,550,18,male,18-24
49800,16500,33300,19,female,18-24
45000,18450,26550,21,female,18-24
26650,13350,13300,32,male,25-39
22100,13150,8950,39,male,25-39
10800,9000,1800,18,male,18-24
10700,10550,150,43,female,40+
56400,19600,36800,21,female,18-24
9150,6900,2250,19,male,18-24
46000,19600,26400,22,female,18-24
11900,9000,2900,19,male,18-24
9950,9050,900,18,male,18-24
38400,17350,21050,18,female,18-24
36800,11000,25800,18,female,18-24
17600,13300,4300,29,FEMALE,25-39
135600,47400,88200,21,male,18-24
43550,25100,18450,22,female,18-24
10900,8600,2300,19,male,18-24
42550,17300,25250,18,female,18-24
40150,15800,24350,18,female,18-24
121350,42400,78950,21,male,18-24
12700,8050,4650,20,male,18-24
36000,17550,18450,22,female,18-24
10750,7050,3700,19,male,18-24
7250,8150,-900,18,male,18-24
10200,6800,3400,18,male,18-24
9350,7900,1450,19,male,18-24
12450,9650,2800,20,male,18-24
21350,10450,10900,28,FEMALE,25-39
7800,8750,-950,19,male,18-24
47600,15950,31650,22,female,18-24
22500,9750,12750,29,FEMALE,25-39
13500,9100,4400,20,male,18-24
52650,19400,33250,21,female,18-24
54400,19850,34550,24,female,18-24
10750,8700,2050,19,male,18-24
5750,7750,-2000,20,male,18-24
55350,19900,35450,22,female,18-24
7600,8250,-650,18,male,18-24
38400,13100,25300,18,female,18-24
13200,8850,4350,18,male,18-24
7450,6300,1150,19,male,18-24
22550,10150,12400,35,Female,25-39
45900,11250,34650,19,female,18-24
55700,20300,35400,21,female,18-24
18950,9550,9400,30,male,25-39
25850,15550,10300,30,FEMALE,25-39
48200,12750,35450,18,female,18-24
123500,37350,86150,22,male,18-24
9200,7100,2100,20,male,18-24
42550,14400,28150,18,female,18-24
35850,17950,17900,22,female,18-24
21200,12750,8450,29,FEMALE,25-39
7150,7700,-550,19,male,18-24
11550,9950,1600,18,male,18-24
12000,8100,3900,18,male,18-24
43650,8050,35600,18,female,18-24
39250,14050,25200,19,female,18-24
39100,16350,22750,19,female,18-24
13750,8550,5200,31,Female,25-39
13500,14250,-750,37,Female,25-39
31950,14500,17450,19,female,18-24
49850,24450,25400,24,female,18-24
20800,10850,9950,32,male,25-39
20800,10800,10000,27,male,25-39
23950,12400,11550,25,male,25-39
8300,10600,-2300,18,male,18-24
52000,17150,34850,24,female,18-24
29750,18300,11450,18,female,18-24
43550,15150,28400,19,female,18-24
12000,8400,3600,20,male,18-24
31500,18350,13150,18,female,18-24
7550,7400,150,19,male,18-24
125950,37200,88750,23,male,18-24
23950,15650,8300,32,Female,25-39
133100,40750,92350,23,male,18-24
12950,15450,-2500,31,male,25-39
27600,16750,10850,20,female,18-24
122400,37300,85100,21,male,18-24
49400,18100,31300,22,female,18-24
20950,14250,6700,28,male,25-39
121300,42550,78750,22,male,18-24
26300,10700,15600,33,Female,25-39
33300,11900,21400,19,female,18-24
132600,38950,93650,21,male,18-24
18500,14400,4100,29,FEMALE,25-39
17000,11700,5300,25,female,25-39
7450,9250,-1800,18,male,18-24
45700,15200,30500,18,female,18-24
12550,7950,4600,18,male,18-24
110100,45750,64350,21,male,18-24
20650,16750,3900,32,Female,25-39
13600,8200,5400,20,male,18-24
9550,6700,2850,18,male,18-24
33200,15400,17800,20,female,18-24
37450,15450,22000,19,female,18-24
11200,8650,2550,18,male,18-24
127350,41800,85550,21,male,18-24
44550,13250,31300,23,female,18-24
17500,13000,4500,39,Female,25-39
7150,7050,100,20,male,18-24
29300,13850,15450,18,female,18-24
19550,12400,7150,33,male,25-39
18150,13650,4500,32,Female,25-39
10100,8150,1950,18,male,18-24
31550,18550,13000,18,female,18-24
35550,13300,22250,19,female,18-24
20700,13200,7500,34,Female,25-39
10300,8750,1550,20,male,18-24
16650,12800,3850,33,Female,25-39
9650,8350,1300,18,male,18-24
41100,23350,17750,22,female,18-24
7350,8200,-850,19,male,18-24
7100,8700,-1600,20,male,18-24
10800,6600,4200,19,male,18-24
7950,8450,-500,19,male,18-24
11900,8400,3500,18,male,18-24
41550,20450,21100,21,female,18-24
10200,7250,2950,18,male,18-24
9150,8150,1000,18,male,18-24
30750,13850,16900,36,male,25-39
9450,8200,1250,19,male,18-24
8900,8200,700,18,male,18-24
7100,8200,-1100,20,male,18-24
25050,14300,10750,26,female,25-39
9400,7150,2250,18,male,18-24
121100,44300,76800,21,male,18-24
104100,40000,64100,22,male,18-24
22600,13000,9600,25,female,25-39
35400,17750,17650,19,female,18-24
42750,14000,28750,19,female,18-24
47750,12800,34950,18,female,18-24
33800,18300,15500,19,female,18-24
45050,18550,26500,21,female,18-24
30250,12100,18150,36,Female,25-39
125200,36850,88350,22,male,18-24
16950,12300,4650,26,male,25-39
11500,7050,4450,18,male,18-24
21950,16500,5450,30,FEMALE,25-39
18600,9900,8700,27,female,25-39
39500,16400,23100,19,female,18-24
120850,38600,82250,23,male,18-24
41600,16750,24850,18,female,18-24
15900,11400,4500,28,female,25-39
6900,8200,-1300,18,male,18-24
9800,7450,2350,20,male,18-24
8850,6350,2500,18,male,18-24
9400,7900,1500,20,male,18-24
17750,15350,2400,27,female,25-39
23000,12300,10700,33,Female,25-39
45600,22450,23150,22,female,18-24
25350,17450,7900,31,Female,25-39
20100,13350,6750,27,male,25-39
51900,14750,37150,19,female,18-24
8850,8050,800,20,male,18-24
12600,10950,1650,29,male,25-39
46450,14400,32050,19,female,18-24
14550,8650,5900,19,male,18-24
22500,10500,12000,27,female,25-39
52200,16100,36100,19,female,18-24
8150,7950,200,18,male,18-24
23800,13750,10050,35,Female,25-39
34850,19800,15050,18,female,18-24
9100,6700,2400,18,male,18-24
9500,7300,2200,19,male,18-24
9200,8100,1100,18,male,18-24
40450,19150,21300,22,female,18-24
10300,5800,4500,18,male,18-24
11750,9600,2150,38,Female,25-39
118000,40550,77450,21,male,18-24
19650,13400,6250,18,female,18-24
46800,14200,32600,19,female,18-24
27150,12700,14450,19,female,18-24
41750,13900,27850,18,female,18-24
41200,8400,32800,18,female,18-24
11100,8900,2200,19,male,18-24
21850,14950,6900,36,male,25-39
38450,8550,29900,18,female,18-24
23600,11950,11650,35,Female,25-39
24150,13050,11100,27,male,25-39
36400,11450,24950,18,female,18-24
51850,21600,30250,21,female,18-24
9450,6950,2500,18,male,18-24
35850,16350,19500,19,female,18-24
39800,12600,27200,19,female,18-24
19500,13500,6000,34,male,25-39
41600,14800,26800,20,female,18-24
41250,13950,27300,19,female,18-24
37450,11750,25700,18,female,18-24
13200,7500,5700,29,male,25-39
13150,9150,4000,19,male,18-24
10600,7500,3100,18,male,18-24
35600,25600,10000,24,female,18-24
9250,8350,900,19,male,18-24
10800,10850,-50,19,male,18-24
8000,8050,-50,20,male,18-24
35800,15200,20600,19,female,18-24
18750,13600,5150,33,Female,25-39
11800,8750,3050,18,male,18-24
61650,18700,42950,21,female,18-24
9700,7350,2350,20,male,18-24
30300,18550,11750,18,female,18-24
47100,15100,32000,19,female,18-24
9400,6800,2600,19,male,18-24
11450,8850,2600,19,male,18-24
11000,8250,2750,18,male,18-24
43150,26050,17100,21,female,18-24
35600,12650,22950,18,female,18-24
16600,10000,6600,27,male,25-39
14750,7850,6900,27,female,25-39
41150,16850,24300,18,female,18-24
10500,8250,2250,20,male,18-24
45450,16500,28950,19,female,18-24
31000,16400,14600,18,female,18-24
39650,22450,17200,22,female,18-24
6654600,10650,6643950,31,male,25-39
12400,9050,3350,18,male,18-24
16200,10900,5300,30,male,25-39
11650,6700,4950,18,male,18-24
38050,14850,23200,19,female,18-24
8300,8900,-600,18,male,18-24
23000,14700,8300,27,female,25-39
41850,16050,25800,24,female,18-24
48900,18700,30200,24,female,18-24
7100,6250,850,18,male,18-24
55200,16050,39150,18,female,18-24
52150,10150,42000,19,female,18-24
13600,8000,5600,20,male,18-24
36600,15900,20700,19,female,18-24
9700,8200,1500,19,male,18-24
6250,8900,-2650,18,male,18-24
10550,7600,2950,18,male,18-24
35450,14250,21200,18,female,18-24
26900,11700,15200,37,Female,25-39
19650,14850,4800,27,male,25-39
14900,9150,5750,18,male,18-24
54900,18900,36000,21,female,18-24
9950,7950,2000,20,male,18-24
6550,6750,-200,20,male,18-24
9550,7650,1900,18,male,18-24
40450,10500,29950,19,female,18-24
19600,9800,9800,32,male,25-39
46750,8500,38250,18,female,18-24
121650,40100,81550,23,male,18-24
43500,11750,31750,19,female,18-24
8050,8900,-850,18,male,18-24
51150,23950,27200,21,female,18-24
21700,12700,9000,25,female,25-39
11350,9950,1400,18,male,18-24
53200,16250,36950,21,female,18-24
9650,8150,1500,19,male,18-24
12700,10250,2450,19,male,18-24
22600,16350,6250,36,Female,25-39
45950,15150,30800,18,female,18-24
56100,23550,32550,21,female,18-24
12550,10900,1650,29,male,25-39
5350,8800,-3450,19,male,18-24
59850,20250,39600,22,female,18-24
6950,8750,-1800,19,male,18-24
61700,16750,44950,19,female,18-24
19400,11100,8300,26,male,25-39
13800,18550,-4750,19,female,18-24
12450,8150,4300,19,male,18-24
12450,8050,4400,19,male,18-24
9350,8950,400,20,male,18-24
21400,11450,9950,25,male,25-39
17250,10500,6750,37,male,25-39
11350,8650,2700,19,male,18-24
14800,9150,5650,18,male,18-24
9650,7750,1900,20,male,18-24
8200,6950,1250,18,male,18-24
50900,16000,34900,21,female,18-24
47150,20300,26850,22,female,18-24
12700,7100,5600,18,male,18-24
9700,10100,-400,20,male,18-24
9650,8100,1550,18,male,18-24
42300,17750,24550,18,female,18-24
12000,8200,3800,18,male,18-24
18500,12450,6050,29,FEMALE,25-39
10850,7150,3700,19,male,18-24
42300,7800,34500,18,female,18-24
46500,21200,25300,19,female,18-24
43750,18650,25100,18,female,18-24
35950,15650,20300,18,female,18-24
41800,15650,26150,19,female,18-24
129850,36450,93400,23,male,18-24
46950,18400,28550,21,female,18-24
10450,6050,4400,20,male,18-24
27700,12500,15200,33,Female,25-39
28600,11000,17600,28,male,25-39
10750,7300,3450,18,male,18-24
11000,6950,4050,18,male,18-24
16300,9750,6550,33,male,25-39
8700,8000,700,20,male,18-24
48900,25700,23200,22,female,18-24
10550,7900,2650,18,male,18-24
13350,10750,2600,27,female,25-39
36200,12850,23350,18,female,18-24
19600,11600,8000,30,FEMALE,25-39
10650,8350,2300,18,male,18-24
20650,10200,10450,25,female,25-39
34350,16650,17700,18,female,18-24
10550,5400,5150,18,male,18-24
49000,10050,38950,18,female,18-24
11000,7250,3750,19,male,18-24
10200,7450,2750,18,male,18-24
27700,9650,18050,28,female,25-39
133200,38500,94700,22,male,18-24
6050,8200,-2150,19,male,18-24
10900,8400,2500,18,male,18-24
23300,14900,8400,18,female,18-24
46300,12200,34100,19,female,18-24
8650,10300,-1650,18,male,18-24
139100,33150,105950,22,male,18-24
41700,16950,24750,18,female,18-24
45950,17150,28800,18,female,18-24
51600,21000,30600,24,female,18-24
19500,13250,6250,32,male,25-39
19550,12750,6800,28,female,25-39
7150,7200,-50,19,male,18-24
9900,7750,2150,19,male,18-24
22250,8450,13800,25,female,25-39
51550,13350,38200,20,female,18-24
20250,13850,6400,36,male,25-39
9850,7350,2500,18,male,18-24
120800,39000,81800,21,male,18-24
8100,8600,-500,18,male,18-24
23600,11050,12550,25,female,25-39
48200,13200,35000,18,female,18-24
17050,10650,6400,29,FEMALE,25-39
8650,7450,1200,20,male,18-24
18200,13950,4250,37,Female,25-39
28200,13650,14550,18,female,18-24
10200,8150,2050,20,male,18-24
25850,11900,13950,25,female,25-39
35700,16600,19100,19,female,18-24
55000,21450,33550,24,female,18-24
9650,9250,400,20,male,18-24
9850,8450,1400,18,male,18-24
9800,7650,2150,19,male,18-24
9300,6300,3000,18,male,18-24
9500,8250,1250,18,male,18-24
41150,15150,26000,18,female,18-24
17450,11750,5700,33,Female,25-39
21800,9000,12800,27,male,25-39
27300,13450,13850,19,female,18-24
33600,16450,17150,19,female,18-24
23050,10150,12900,39,Female,25-39
20050,14250,5800,28,male,25-39
38150,18950,19200,21,female,18-24
20900,12800,8100,18,female,18-24
42050,15750,26300,21,female,18-24
38150,12250,25900,19,female,18-24
25600,11150,14450,30,male,25-39
26400,15500,10900,39,male,25-39
11050,8950,2100,18,male,18-24
30950,19850,11100,19,female,18-24
43850,14800,29050,19,female,18-24
130100,41000,89100,21,male,18-24
12700,7850,4850,20,male,18-24
9900,7250,2650,19,male,18-24
113300,42100,71200,21,male,18-24
19550,7800,11750,39,Female,25-39
14850,15250,-400,34,Female,25-39
35700,4950,30750,19,female,18-24
38400,14650,23750,18,female,18-24
38500,23950,14550,22,female,18-24
10750,7350,3400,19,male,18-24
42150,23250,18900,21,female,18-24
12000,8200,3800,18,male,18-24
35050,18200,16850,18,female,18-24
47150,16300,30850,18,female,18-24
49500,12100,37400,18,female,18-24
50900,12450,38450,19,female,18-24
8150,9000,-850,19,male,18-24
46700,15350,31350,19,female,18-24
18450,13700,4750,26,female,25-39
13600,9650,3950,36,male,25-39
34000,15450,18550,18,female,18-24
48100,20500,27600,19,female,18-24
12200,10250,1950,20,male,18-24
50750,15350,35400,19,female,18-24
9100,8650,450,19,male,18-24
16700,13750,2950,31,Female,25-39
9600,7050,2550,20,male,18-24
12700,8850,3850,19,male,18-24
44900,18350,26550,18,female,18-24
39100,15150,23950,18,female,18-24
17500,14800,2700,29,FEMALE,25-39
18700,9750,8950,35,Female,25-39
113550,42700,70850,21,male,18-24
18000,11950,6050,28,female,25-39
12750,10450,2300,35,male,25-39
8200,8050,150,19,male,18-24
13300,14750,-1450,26,female,25-39
18650,12950,5700,30,FEMALE,25-39
10450,7950,2500,18,male,18-24
40150,16050,24100,18,female,18-24
9800,8050,1750,19,male,18-24
48550,14800,33750,18,female,18-24
10250,9300,950,20,male,18-24
39050,16600,22450,18,female,18-24
52200,8550,43650,19,female,18-24
9000,8000,1000,18,male,18-24
12200,8700,3500,19,male,18-24
11250,7550,3700,18,male,18-24
36500,19350,17150,18,female,18-24
8900,7800,1100,18,male,18-24
95700,39300,56400,22,male,18-24
10200,8800,1400,18,male,18-24
31500,16350,15150,24,female,18-24
48300,20450,27850,21,female,18-24
9850,8550,1300,18,male,18-24
28250,10250,18000,27,male,25-39
132650,40300,92350,22,male,18-24
13100,10950,2150,18,male,18-24
19750,10300,9450,28,male,25-39
19200,12000,7200,26,female,25-39
35200,12550,22650,18,female,18-24
22300,11550,10750,19,female,18-24
65150,17900,47250,22,female,18-24
32350,17250,15100,19,female,18-24
11500,7950,3550,18,male,18-24
8400,7050,1350,18,male,18-24
21850,13350,8500,34,male,25-39
44300,18450,25850,18,female,18-24
40400,16500,23900,19,female,18-24
11700,8200,3500,19,male,18-24
14150,13850,300,27,female,25-39
40200,19350,20850,19,female,18-24
10300,8200,2100,20,male,18-24
7650,6650,1000,19,male,18-24
34800,15700,19100,18,female,18-24
13200,7850,5350,18,male,18-24
20850,12700,8150,28,female,25-39
11700,7900,3800,19,male,18-24
36400,19550,16850,22,female,18-24
6300,9600,-3300,19,male,18-24
16500,13800,2700,35,male,25-39
8050,9350,-1300,19,male,18-24
13700,8850,4850,19,male,18-24
10600,8200,2400,19,male,18-24
11100,7250,3850,20,male,18-24
27750,12550,15200,30,male,25-39
54550,28750,25800,24,female,18-24
125650,36000,89650,21,male,18-24
107500,37650,69850,21,male,18-24
117300,40950,76350,22,male,18-24
35050,17750,17300,18,female,18-24
9700,7950,1750,18,male,18-24
27050,12700,14350,19,female,18-24
12900,7400,5500,18,male,18-24
8500,8550,-50,18,male,18-24
17800,11950,5850,26,male,25-39
7600,7900,-300,20,male,18-24
9750,9550,200,18,male,18-24
120250,40450,79800,21,male,18-24
21450,10600,10850,26,male,25-39
38850,17800,21050,18,female,18-24
21700,9650,12050,31,male,25-39
21250,11450,9800,30,male,25-39
31050,15200,15850,18,female,18-24
16800,11950,4850,30,male,25-39
44800,17600,27200,18,female,18-24
47750,20150,27600,24,female,18-24
8400,15550,-7150,25,female,25-39
46600,13000,33600,18,female,18-24
35850,18950,16900,18,female,18-24
23150,15350,7800,25,female,25-39
18350,14600,3750,28,female,25-39
43150,17850,25300,18,female,18-24
14650,9050,5600,18,male,18-24
12600,13300,-700,32,Female,25-39
21500,15600,5900,38,Female,25-39
50150,15150,35000,19,female,18-24
9050,9500,-450,20,male,18-24
40800,12200,28600,18,female,18-24
19750,12450,7300,25,male,25-39
21000,13600,7400,33,Female,25-39
39300,16850,22450,19,female,18-24
8500,11950,-3450,37,Female,25-39
38100,13750,24350,18,female,18-24
10150,8450,1700,18,male,18-24
35950,13150,22800,18,female,18-24
4800,8750,-3950,18,male,18-24
42400,15500,26900,18,female,18-24
11950,8200,3750,18,male,18-24
51600,10550,41050,18,female,18-24
12600,8000,4600,19,male,18-24
9950,9050,900,18,male,18-24
7150,8300,-1150,18,male,18-24
29000,15500,13500,19,female,18-24
130050,46950,83100,23,male,18-24
32150,17350,14800,19,female,18-24
12100,7300,4800,20,male,18-24
56450,18000,38450,22,female,18-24
11250,6600,4650,20,male,18-24
100200,40450,59750,21,male,18-24
39450,14200,25250,19,female,18-24
10000,7000,3000,18,male,18-24
12200,9050,3150,18,male,18-24
120900,42650,78250,21,male,18-24
21050,12400,8650,26,male,25-39
20400,10950,9450,32,male,25-39
10000,7950,2050,19,male,18-24
8350,8750,-400,20,male,18-24
9650,8000,1650,19,male,18-24
22850,14200,8650,32,male,25-39
56650,14800,41850,19,female,18-24
34200,18700,15500,22,female,18-24
36200,17050,19150,19,female,18-24
45200,20550,24650,22,female,18-24
11950,9350,2600,18,male,18-24
8900,7350,1550,20,male,18-24
65750,17400,48350,18,female,18-24
25150,10600,14550,32,male,25-39
9650,9800,-150,40,male,40+
27000,11350,15650,37,Female,25-39
19950,12200,7750,34,Female,25-39
38350,16350,22000,19,female,18-24
23400,10450,12950,26,male,25-39
14500,13450,1050,31,Female,25-39
37800,16350,21450,19,female,18-24
10150,9150,1000,18,male,18-24
46800,12900,33900,18,female,18-24
11250,9650,1600,18,male,18-24
13550,6850,6700,19,male,18-24
103350,35100,68250,22,male,18-24
12900,11250,1650,32,male,25-39
21200,13350,7850,28,male,25-39
12650,8200,4450,19,male,18-24
52100,18750,33350,23,female,18-24
11000,7650,3350,18,male,18-24
10350,7750,2600,20,male,18-24
26600,14050,12550,19,female,18-24
22650,10800,11850,35,Female,25-39
52950,9800,43150,18,female,18-24
35700,9200,26500,19,female,18-24
17100,12500,4600,26,female,25-39
9050,7900,1150,19,male,18-24
20350,11150,9200,30,FEMALE,25-39
8100,8500,-400,18,male,18-24
27150,15200,11950,31,male,25-39
40600,16850,23750,18,female,18-24
17900,14550,3350,25,female,25-39
10450,8300,2150,19,male,18-24
22350,11550,10800,29,male,25-39
31950,15400,16550,18,female,18-24
18700,12600,6100,29,FEMALE,25-39
9100,7400,1700,19,male,18-24
125400,32700,92700,23,male,18-24
12450,6600,5850,18,male,18-24
28350,14500,13850,19,female,18-24
10200,11650,-1450,41,female,40+
12600,11050,1550,26,female,25-39
52400,14600,37800,18,female,18-24
24700,9100,15600,25,male,25-39
23950,12350,11600,26,female,25-39
13700,12250,1450,32,male,25-39
15000,13150,1850,35,male,25-39
17050,13200,3850,38,male,25-39
18300,12800,5500,36,male,25-39
18250,12150,6100,34,male,25-39
9350,8500,850,19,male,18-24
6250,7800,-1550,18,male,18-24
11650,7400,4250,18,male,18-24
23400,11950,11450,18,female,18-24
22050,11850,10200,29,male,25-39
49400,20200,29200,19,female,18-24
17150,11750,5400,25,female,25-39
7750,6650,1100,19,male,18-24
5650,7400,-1750,19,male,18-24
26950,18000,8950,19,female,18-24
23500,13400,10100,28,male,25-39
53150,16500,36650,19,female,18-24
16900,8050,8850,25,female,25-39
40750,15300,25450,19,female,18-24
21250,12000,9250,31,Female,25-39
34600,14200,20400,19,female,18-24
35750,16650,19100,18,female,18-24
11400,6800,4600,19,male,18-24
45650,15050,30600,19,female,18-24
23250,14200,9050,25,female,25-39
7200,9550,-2350,18,male,18-24
7250,6400,850,18,male,18-24
21100,14400,6700,36,male,25-39
52450,21600,30850,21,female,18-24
23900,14450,9450,37,male,25-39
24800,11750,13050,25,male,25-39
12000,5950,6050,19,male,18-24
17600,12400,5200,27,female,25-39
47050,15100,31950,18,female,18-24
25300,12100,13200,37,male,25-39
10450,6750,3700,19,male,18-24
8400,8250,150,19,male,18-24
8100,7600,500,19,male,18-24
20450,13650,6800,28,female,25-39
20100,12050,8050,25,female,25-39
16050,10650,5400,29,FEMALE,25-39
11150,9400,1750,20,male,18-24
10500,7550,2950,18,male,18-24
5600,9250,-3650,18,male,18-24
23950,12050,11900,27,male,25-39
8650,8600,50,18,male,18-24
45350,14350,31000,19,female,18-24
41700,9900,31800,18,female,18-24
120600,49650,70950,21,male,18-24
21700,13150,8550,33,Female,25-39
